Date;Text;Amount;Saldo;Currency
07/10/2019;Visa/Dankort IZ *ANDERSEN, KOBENHAVN N,;-38;509430,18;DKK
07/10/2019;Krystal Sandwich;-69;509468,18;DKK
04/10/2019;Visa/Dankort OISTER.DK, KOBENHAVN,;-89;509537,18;DKK
01/10/2019;AKADEMIKERNES A-KASSE;-1320;509626,18;DKK
30/09/2019;Account 64970001000373;-10000;510946,18;DKK
27/09/2019;Dankort Coffee Industri Sw;-70;520946,18;DKK
27/09/2019;Dankort Coffee Industri Sw;-25;521016,18;DKK
26/09/2019;Dankort Cafeteriet Herlev;-53;521041,18;DKK
26/09/2019;cykelgear.dk Nota 1367882;-407;521094,18;DKK
25/09/2019;Dankort 7-Eleven B 087;-39;521501,18;DKK
23/09/2019;Dankort SØREN K;-120;521540,18;DKK
23/09/2019;Dankort Panum Hovedkantine;-32,71;521660,18;DKK
20/09/2019;Dankort Panum Hovedkantine;-35,26;521692,89;DKK
20/09/2019;Dankort Democratic Coffee;-66;521728,15;DKK
19/09/2019;Dankort Panum Hovedkantine;-35,11;521794,15;DKK
17/09/2019;Dankort Panum Hovedkantine;-27,05;521829,26;DKK
16/09/2019;Dankort Kaf;-153;521856,31;DKK
16/09/2019;Dankort PHOTOGRAFICA;-55;522009,31;DKK
16/09/2019;Dankort Panum Hovedkantine;-37,67;522064,31;DKK
16/09/2019;Københavns Universit;10009,89;522101,98;DKK
13/09/2019;Dankort Panum Hovedkantine;-25;512092,09;DKK
13/09/2019;Dankort Coffee Industri Sw;-95;512117,09;DKK
11/09/2019;Dankort Panum Hovedkantine;-36,58;512212,09;DKK
11/09/2019;Dankort Democratic Coffee;-88;512248,67;DKK
09/09/2019;Dankort Rema 1000;-23,85;512336,67;DKK
09/09/2019;Dankort Normal A/S;-55;512360,52;DKK
09/09/2019;Dankort Rema 1000;-28,95;512415,52;DKK
05/09/2019;Dankort Panum Hovedkantine;-35,19;512444,47;DKK
04/09/2019;Dankort Smag ApS;-64;512479,66;DKK
04/09/2019;Visa/Dankort OISTER.DK, KOBENHAVN,;-89;512543,66;DKK
04/09/2019;Dankort Democratic Coffee;-110;512632,66;DKK
03/09/2019;Dankort Panum Hovedkantine;-25;512742,66;DKK
03/09/2019;Visa/Dankort IZ *ANDERSEN, KOBENHAVN N,;-126;512767,66;DKK
02/09/2019;Dankort Aldi 002;-137,45;512893,66;DKK
02/09/2019;Dankort Panum Hovedkantine;-28,6;513031,11;DKK
30/08/2019;Dankort Panum Hovedkantine;-36,35;513059,71;DKK
30/08/2019;Account 64970001000373;-10000;513096,06;DKK
30/08/2019;Københavns Universit;22471,27;523096,06;DKK
30/08/2019;Nørrebro Apotek v/;-1646,95;500624,79;DKK
29/08/2019;Dankort Panum Hovedkantine;-34,49;502271,74;DKK
29/08/2019;Dankort Panum Hovedkantine;-25,03;502306,23;DKK
28/08/2019;Rema 1000;-214,5;502331,26;DKK
27/08/2019;Dankort Yogaudstyr.dk;-227;502545,76;DKK
27/08/2019;Dankort Flying Tiger Cph37;-30;502772,76;DKK
27/08/2019;Dankort Panum Hovedkantine;-38,44;502802,76;DKK
27/08/2019;HSO*WWW.BERGFREUNDE.DK, 72138. DE EUR 74,95;-564,63;502841,2;DKK
26/08/2019;Dankort Democratic Coffee;-33;503405,83;DKK
26/08/2019;Dankort Panum Hovedkantine;-33,17;503438,83;DKK
23/08/2019;Dankort Panum Hovedkantine;-33,64;503472;DKK
23/08/2019;Dankort Panum Hovedkantine;-33,25;503505,64;DKK
21/08/2019;Dankort Panum Hovedkantine;-31;503538,89;DKK
21/08/2019;Visa/Dankort IZ *ANDERSEN, KOBENHAVN N,;-101;503569,89;DKK
20/08/2019;Dankort Panum Hovedkantine;-39,99;503670,89;DKK
20/08/2019;Visa/Dankort KAFFEPLANTAGEN, KOBENHAVN N,;-95;503710,88;DKK
20/08/2019;Pengeautomat;-500;503805,88;DKK
19/08/2019;Dankort Flying Tiger Cph78;-30;504305,88;DKK
19/08/2019;Dankort beAwear;-450;504335,88;DKK
19/08/2019;Dankort Aldi 002;-108,6;504785,88;DKK
19/08/2019;Dankort Panum Hovedkantine;-34,57;504894,48;DKK
19/08/2019;Dankort Panum Hovedkantine;-30,23;504929,05;DKK
15/08/2019;Dankort Panum Hovedkantine;-26,27;504959,28;DKK
15/08/2019;Visa/Dankort SEK 86,00 Kurs 70,755 Nota nr. 00728 NORMAL EMPORIA, MALMO;-60,85;504985,55;DKK
12/08/2019;MobilePay: Sandra Urioste;-20;505046,4;DKK
07/08/2019;MobilePay køb Bornholm på Hjul;-140;505066,4;DKK
06/08/2019;Visa/Dankort OISTER.DK, KOBENHAVN,;-89;505206,4;DKK
05/08/2019;Dankort Panum Hovedkantine;-34,49;505295,4;DKK
02/08/2019;Dankort Panum Hovedkantine;-42,08;505329,89;DKK
02/08/2019;Visa/Dankort KAFFEPLANTAGEN, KOBENHAVN N,;-74;505371,97;DKK
01/08/2019;Dankort Flying Tiger Cph78;-30;505445,97;DKK
01/08/2019;Dankort Panum Hovedkantine;-44,02;505475,97;DKK
01/08/2019;Dankort Panum Hovedkantine;-30,85;505519,99;DKK
31/07/2019;Account 64970001000373;-10000;505550,84;DKK
31/07/2019;Københavns Universit;22471,27;515550,84;DKK
30/07/2019;Dankort Panum Hovedkantine;-40,46;493079,57;DKK
29/07/2019;Dankort Panum Hovedkantine;-36,12;493120,03;DKK
26/07/2019;Dankort Panum Hovedkantine;-40,07;493156,15;DKK
25/07/2019;Dankort Panum Hovedkantine;-40,61;493196,22;DKK
24/07/2019;Dankort Panum Hovedkantine;-37,51;493236,83;DKK
23/07/2019;Dankort Panum Hovedkantine;-39,06;493274,34;DKK
22/07/2019;Rejsekort - DSB Nota CF019826344;-300;493313,4;DKK
19/07/2019;Dankort Apoteket Frederiks;-64,25;493613,4;DKK
19/07/2019;Dankort Panum Hovedkantine;-38,52;493677,65;DKK
19/07/2019;Pengeautomat;-300;493716,17;DKK
18/07/2019;Dankort Panum Hovedkantine;-38,6;494016,17;DKK
17/07/2019;Dankort Panum Hovedkantine;-36,12;494054,77;DKK
16/07/2019;Dankort Panum Hovedkantine;-44,56;494090,89;DKK
15/07/2019;Dankort Normal A/S;-41;494135,45;DKK
15/07/2019;Cafe Satchmo;-182;494176,45;DKK
15/07/2019;MobilePay: Patryk Fraczyk;-36;494358,45;DKK
15/07/2019;Dankort Panum Hovedkantine;-40,77;494394,45;DKK
15/07/2019;MobilePay: Patryk Fr;75;494435,22;DKK
12/07/2019;Dankort Panum Hovedkantine;-40,69;494360,22;DKK
12/07/2019;Dankort Democratic Coffee;-33;494400,91;DKK
11/07/2019;Dankort Panum Hovedkantine;-38,75;494433,91;DKK
10/07/2019;Dankort Panum Hovedkantine;-33,33;494472,66;DKK
10/07/2019;Dankort Democratic Coffee;-88;494505,99;DKK
09/07/2019;Dankort Panum Hovedkantine;-40,84;494593,99;DKK
09/07/2019;Visa/Dankort KAFFEPLANTAGEN, KOBENHAVN N,;-85;494634,83;DKK
08/07/2019;Dankort Normal A/S;-43;494719,83;DKK
08/07/2019;Dankort Panum Hovedkantine;-34,72;494762,83;DKK
05/07/2019;Dankort Panum Hovedkantine;-38,36;494797,55;DKK
05/07/2019;DSB19-7802659005;175,2;494835,91;DKK
04/07/2019;Dankort Panum Hovedkantine;-35,73;494660,71;DKK
04/07/2019;Dankort Panum Hovedkantine;-34,95;494696,44;DKK
04/07/2019;Visa/Dankort OISTER.DK, KOBENHAVN,;-89;494731,39;DKK
02/07/2019;Dankort Panum Hovedkantine;-34,72;494820,39;DKK
02/07/2019;Visa/Dankort FS DE SCANDLINES DE GMBH , HAMBURG,;-12;494855,11;DKK
01/07/2019;Dankort Flying Tiger Cph37;-30;494867,11;DKK
01/07/2019;AKADEMIKERNES A-KASSE;-1320;494897,11;DKK
28/06/2019;Dankort Panum Hovedkantine;-39,06;496217,11;DKK
28/06/2019;Account 64970001000373;-10000;496256,17;DKK
28/06/2019;Københavns Universit;22471,27;506256,17;DKK
28/06/2019;DSB 646 Kn RKA;-200;483784,9;DKK
27/06/2019;Dankort Mokkariet Odensega;-90;483984,9;DKK
27/06/2019;Dankort Panum Hovedkantine;-30,77;484074,9;DKK
26/06/2019;Dankort Nørrebro Apotek v/;-109;484105,67;DKK
26/06/2019;Dankort Panum Hovedkantine;-31,47;484214,67;DKK
25/06/2019;Dankort Panum Hovedkantine;-33,56;484246,14;DKK
25/06/2019;Visa/Dankort LEVI STRAUSS DENMARK,, Kobenhavn,;-734;484279,7;DKK
25/06/2019;Visa/Dankort IZ *THE LITTLE CAF, TISVILDELEJE,;-190;485013,7;DKK
24/06/2019;MobilePay: Mette Ludwig;-20;485203,7;DKK
24/06/2019;Visa/Dankort IZ *ANDERSEN, KOBENHAVN N,;-76;485223,7;DKK
24/06/2019;DSB 653 Nht RKA;-300;485299,7;DKK
24/06/2019;MobilePay: Maria Camila Alvarez Silva;-150;485599,7;DKK
24/06/2019;MobilePay: Maria Cam;300;485749,7;DKK
21/06/2019;Dankort Yogaudstyr.dk;-767;485449,7;DKK
21/06/2019;Rejsekort - DSB Nota C90b8f463131;-50;486216,7;DKK
21/06/2019;Dankort Panum Hovedkantine;-40,77;486266,7;DKK
20/06/2019;Dankort Empire Bio A/S;-42;486307,47;DKK
20/06/2019;Dankort Panum Hovedkantine;-32,63;486349,47;DKK
20/06/2019;Visa/Dankort 00000000;-76;486382,1;DKK
19/06/2019;Dankort Nørrebro Apotek v/;-115,45;486458,1;DKK
19/06/2019;Dankort Panum Hovedkantine;-34,88;486573,55;DKK
18/06/2019;Dankort Panum Hovedkantine;-38,29;486608,43;DKK
17/06/2019;Visa/Dankort KAFFEPLANTAGEN, KOBENHAVN N,;-77;486646,72;DKK
17/06/2019;Dankort Panum Hovedkantine;-38,52;486723,72;DKK
14/06/2019;Dankort DET FRANSKE CONDIT;-151;486762,24;DKK
14/06/2019;Dankort Rema 1000;-126,95;486913,24;DKK
14/06/2019;Dankort Panum Hovedkantine;-40,38;487040,19;DKK
14/06/2019;Visa/Dankort IZ *GAO DUMPLING B, COPENHAGEN N,;-385;487080,57;DKK
13/06/2019;Dankort Panum Hovedkantine;-43,09;487465,57;DKK
12/06/2019;Visa/Dankort IZ *MASTER THAI CU, LISELEJE,;-383;487508,66;DKK
12/06/2019;Visa/Dankort IZ *MASTER THAI CU, LISELEJE,;-338;487891,66;DKK
12/06/2019;Visa/Dankort IZ *THE OLD COFFEE, HUNDESTED,;-84;488229,66;DKK
12/06/2019;Visa/Dankort HANSENS ISBAR OG CAFE, LISELEJE,;-82;488313,66;DKK
11/06/2019;Dankort Liselængen-Liselej;-166;488395,66;DKK
11/06/2019;Dankort Netto H.C Ørstedsv;-25,95;488561,66;DKK
11/06/2019;Pengeautomat;-300;488587,61;DKK
07/06/2019;Dankort SILVAN 637 Fisketo;-227,84;488887,61;DKK
07/06/2019;Dankort Panum Hovedkantine;-29,22;489115,45;DKK
07/06/2019;Visa/Dankort IZ *ANDERSEN, KOBENHAVN N,;-76;489144,67;DKK
06/06/2019;Visa/Dankort EASYPARK, 2467890538,;-370;489220,67;DKK
06/06/2019;Visa/Dankort OISTER.DK, KOBENHAVN,;-89;489590,67;DKK
06/06/2019;Dankort Panum Hovedkantine;-34,95;489679,67;DKK
04/06/2019;Dankort Panum Hovedkantine;-33,48;489714,62;DKK
04/06/2019;Visa/Dankort JOE,;-44;489748,1;DKK
04/06/2019;Pengeautomat;-400;489792,1;DKK
03/06/2019;Dankort Nørrebro Apotek v/;-109;490192,1;DKK
03/06/2019;Dankort Panum Hovedkantine;-34,95;490301,1;DKK
29/05/2019;Dankort Panum Hovedkantine;-43,94;490336,05;DKK
29/05/2019;Dankort Panum Hovedkantine;-43,63;490379,99;DKK
29/05/2019;Visa/Dankort GAGRN APS, KBENHAVN,;-65;490423,62;DKK
29/05/2019;Account 64970001000373;-10000;490488,62;DKK
29/05/2019;Københavns Universit;22471,27;500488,62;DKK
28/05/2019;Visa/Dankort LOOKFANTASTIC.COM, 01618131710,;-111;478017,35;DKK
28/05/2019;Visa/Dankort GAGRN APS, KBENHAVN,;-89;478128,35;DKK
27/05/2019;vinterbadbryggen.d Nota 2445852122;250;478217,35;DKK
27/05/2019;Dankort Panum Hovedkantine;-37,43;477967,35;DKK
27/05/2019;Dankort Panum Hovedkantine;-34,95;478004,78;DKK
27/05/2019;Pengeautomat;-800;478039,73;DKK
27/05/2019;Dankort Democratic Coffee;-66;478839,73;DKK
23/05/2019;Dankort Panum Hovedkantine;-40,38;478905,73;DKK
23/05/2019;Visa/Dankort IZ *ANDERSEN, KOBENHAVN N,;-76;478946,11;DKK
22/05/2019;Dankort Panum Hovedkantine;-41,08;479022,11;DKK
22/05/2019;Dankort Panum Hovedkantine;-34,49;479063,19;DKK
21/05/2019;Dankort Coffee Factory Swe;-70;479097,68;DKK
20/05/2019;vinterbadbryggen.d;-250;479167,68;DKK
20/05/2019;Dankort Panum Hovedkantine;-40,61;479417,68;DKK
16/05/2019;Dankort Panum Hovedkantine;-40,3;479458,29;DKK
15/05/2019;Dankort Panum Hovedkantine;-36,35;479498,59;DKK
14/05/2019;Dankort Panum Hovedkantine;-25;479534,94;DKK
13/05/2019;Dankort Tandlægerne Rømers;-1363,32;479559,94;DKK
13/05/2019;liselangen.dk Nota 10794821;-1690;480923,26;DKK
13/05/2019;Liselængen-Liselej;-96;482613,26;DKK
13/05/2019;Dankort Panum Hovedkantine;-42,55;482709,26;DKK
10/05/2019;Dankort Panum Hovedkantine;-40,92;482751,81;DKK
09/05/2019;Dankort Panum Hovedkantine;-39,91;482792,73;DKK
08/05/2019;MobilePay: Carmen Leyre Saenz Ausejo;-44,6;482832,64;DKK
08/05/2019;Dankort Panum Hovedkantine;-35,96;482877,24;DKK
08/05/2019;Visa/Dankort Flixbus, Berlin,;-498;482913,2;DKK
07/05/2019;Dankort The Coffee Collect;-30;483411,2;DKK
07/05/2019;Dankort Panum Hovedkantine;-42,47;483441,2;DKK
06/05/2019;Visa/Dankort OISTER.DK, KOBENHAVN,;-89;483483,67;DKK
06/05/2019;Dankort Normal A/S;-53;483572,67;DKK
06/05/2019;Dankort SØREN K;-50;483625,67;DKK
06/05/2019;Dankort Panum Hovedkantine;-39,29;483675,67;DKK
03/05/2019;Dankort Aldi 002;-71,65;483714,96;DKK
03/05/2019;MobilePay: Sophia Metz;-14;483786,61;DKK
03/05/2019;Dankort Panum Hovedkantine;-35,96;483800,61;DKK
03/05/2019;Visa/Dankort IZ *THE LITTLE CAF, TISVILDELEJE,;-130;483836,57;DKK
03/05/2019;Visa/Dankort IZ *THE LITTLE CAF, TISVILDELEJE,;-30;483966,57;DKK
03/05/2019;Dankort Rema 1000;-70,8;483996,57;DKK
02/05/2019;Visa/Dankort WWW.CPHSUPTOURS.DK, HILLERD,;-600;484067,37;DKK
01/05/2019;Dankort Tandlægerne Rømers;-528,88;484667,37;DKK
01/05/2019;DSB 646 Kn RKA;-300;485196,25;DKK
01/05/2019;Dankort Netto Nørrevold;-54,85;485496,25;DKK
01/05/2019;Dankort Panum Hovedkantine;-38,44;485551,1;DKK
30/04/2019;Dankort Panum Hovedkantine;-35,5;485589,54;DKK
30/04/2019;Account 64970001000373;-10000;485625,04;DKK
30/04/2019;Københavns Universit;25572,24;495625,04;DKK
29/04/2019;Dankort Hotel Chocolat Str;-26;470052,8;DKK
29/04/2019;Dankort Parterre;-195;470078,8;DKK
29/04/2019;MobilePay: Maria Cam;100;470273,8;DKK
29/04/2019;Dankort Panum Hovedkantine;-34,57;470173,8;DKK
26/04/2019;Dankort Flying Tiger Cph78;-30;470208,37;DKK
26/04/2019;Dankort Panum Hovedkantine;-36,58;470238,37;DKK
25/04/2019;Dankort Panum Hovedkantine;-43,71;470274,95;DKK
25/04/2019;Dankort Panum Hovedkantine;-35,88;470318,66;DKK
25/04/2019;Dankort Democratic Coffee;-102;470354,54;DKK
24/04/2019;Visa/Dankort GOB SKINCARE APS, KBENHAVN N,;-150;470456,54;DKK
24/04/2019;Visa/Dankort LOOKFANTASTIC.COM, 01618131710,;-138;470606,54;DKK
23/04/2019;Dankort Aldi 002;-76,95;470744,54;DKK
23/04/2019;Blågårds Blomster;-200;470821,49;DKK
23/04/2019;Dankort Banh Mi Kim;-58;471021,49;DKK
23/04/2019;Dankort Panum Hovedkantine;-34,64;471079,49;DKK
17/04/2019;Dankort Panum Hovedkantine;-43,25;471114,13;DKK
17/04/2019;Dankort Panum Hovedkantine;-40,53;471157,38;DKK
15/04/2019;Dankort Bravissimo-Bryggen;-54;471197,91;DKK
15/04/2019;Dankort Panum Hovedkantine;-44,33;471251,91;DKK
15/04/2019;Dankort Panum Hovedkantine;-42,32;471296,24;DKK
12/04/2019;webapoteket.dk Nota 2424287357;-30,35;471338,56;DKK
12/04/2019;EHLERS-DANLOS FORENINGEN I DK;-100;471368,91;DKK
11/04/2019;Dankort Panum Hovedkantine;-40,22;471468,91;DKK
10/04/2019;Dankort Panum Hovedkantine;-40,38;471509,13;DKK
09/04/2019;Dankort Nørrebro Apotek v/;-159,95;471549,51;DKK
09/04/2019;Dankort Panum Hovedkantine;-43,94;471709,46;DKK
08/04/2019;DSB 626 Kh RKA;-300;471753,4;DKK
08/04/2019;Dankort Panum Hovedkantine;-47,04;472053,4;DKK
05/04/2019;Dankort Panum Hovedkantine;-44,8;472100,44;DKK
05/04/2019;IZ *ANDERSEN, KOBENHAVN N;-95;472145,24;DKK
04/04/2019;Dankort Panum Hovedkantine;-34,95;472240,24;DKK
04/04/2019;OISTER.DK, KOBENHAVN;-89;472275,19;DKK
03/04/2019;Dankort Panum Hovedkantine;-35,88;472364,19;DKK
02/04/2019;Dankort Panum Hovedkantine;-37,12;472400,07;DKK
02/04/2019;OISTER.DK, KOBENHAVN;-99;472437,19;DKK
01/04/2019;AKADEMIKERNES A-KASSE;-1320;472536,19;DKK
01/04/2019;Parterre;-60;473856,19;DKK
01/04/2019;Dankort Panum Hovedkantine;-46,11;473916,19;DKK
01/04/2019;Dankort FORENINGEN STUDENT;-36;473962,3;DKK
01/04/2019;Dankort Panum Hovedkantine;-32,47;473998,3;DKK
01/04/2019;Dankort FORENINGEN STUDENT;-4;474030,77;DKK
01/04/2019;Dankort FORENINGEN STUDENT;-60;474034,77;DKK
01/04/2019;Dankort FORENINGEN STUDENT;-60;474094,77;DKK
01/04/2019;MobilePay: Maria Cam;20;474154,77;DKK
01/04/2019;MobilePay: Sophia Me;20;474134,77;DKK
01/04/2019;MobilePay: Maria Cam;20;474114,77;DKK
29/03/2019;Account 64970001000373;-10000;474094,77;DKK
29/03/2019;Københavns Universit;22264,54;484094,77;DKK
28/03/2019;Dankort Flying Tiger Cph37;-30;461830,23;DKK
28/03/2019;Dankort Panum Hovedkantine;-39,6;461860,23;DKK
27/03/2019;Dankort Panum Hovedkantine;-35,73;461899,83;DKK
27/03/2019;MAHALLE CPH IVS, KBENHAVN N;-139;461935,56;DKK
26/03/2019;Dankort Panum Hovedkantine;-30,69;462074,56;DKK
25/03/2019;hoopz.dk Nota 136755;-700;462105,25;DKK
25/03/2019;Dankort Smag ApS;-126;462805,25;DKK
25/03/2019;Dankort Panum Hovedkantine;-40,38;462931,25;DKK
21/03/2019;Dankort Panum Hovedkantine;-33,17;462971,63;DKK
20/03/2019;Dankort Empire Bio A/S;-42;463004,8;DKK
20/03/2019;Dankort Panum Hovedkantine;-41,54;463046,8;DKK
19/03/2019;Dankort Panum Hovedkantine;-36,81;463088,34;DKK
19/03/2019;Overførsel;1237,24;463125,15;DKK
18/03/2019;Dankort COFFEE COLLECTIVE;-80;461887,91;DKK
18/03/2019;Dankort Foto 1 Time;-129;461967,91;DKK
18/03/2019;Dankort Panum Hovedkantine;-38,6;462096,91;DKK
18/03/2019;Dankort Flying Tiger Cph37;-20;462135,51;DKK
15/03/2019;Dankort Panum Hovedkantine;-44,64;462155,51;DKK
14/03/2019;Dankort Panum Hovedkantine;-33,02;462200,15;DKK
13/03/2019;MobilePay: Theresia Schnurr;-20;462233,17;DKK
13/03/2019;Dankort Panum Hovedkantine;-36,74;462253,17;DKK
13/03/2019;IZ *VITAMIN BOX, KOBENHAVN N;-117;462289,91;DKK
12/03/2019;Dankort Panum Hovedkantine;-29,92;462406,91;DKK
08/03/2019;Dankort Comwell Borupgaard;-95;462436,83;DKK
07/03/2019;Dankort Panum Hovedkantine;-36,97;462531,83;DKK
06/03/2019;Dankort Panum Hovedkantine;-39,29;462568,8;DKK
06/03/2019;Pengeautomat;-300;462608,09;DKK
06/03/2019;Dankort Democratic Coffee;-114;462908,09;DKK
05/03/2019;Dankort Panum Hovedkantine;-35,03;463022,09;DKK
05/03/2019;OISTER.DK, KOBENHAVN;-89;463057,12;DKK
04/03/2019;Dankort Panum Hovedkantine;-33,87;463146,12;DKK
01/03/2019;Dankort Panum Hovedkantine;-33,87;463179,99;DKK
01/03/2019;MobilePay: Bettina LENGGER;-25;463213,86;DKK
28/02/2019;Dankort Panum Hovedkantine;-38,13;463238,86;DKK
28/02/2019;Account 64970001000373;-10000;463276,99;DKK
28/02/2019;Københavns Universit;24393,54;473276,99;DKK
27/02/2019;Dankort Smag ApS;-126;448883,45;DKK
27/02/2019;Dankort Coffee Factory Swe;-65;449009,45;DKK
27/02/2019;Dankort Nørrebro Apotek v/;-21,55;449074,45;DKK
27/02/2019;Dankort Panum Hovedkantine;-42,01;449096;DKK
26/02/2019;Dankort Empire Bio A/S;-42;449138,01;DKK
26/02/2019;Dankort Panum Hovedkantine;-38,29;449180,01;DKK
25/02/2019;DSB 646 Kn RKA;-300;449218,3;DKK
25/02/2019;Dankort Panum Hovedkantine;-42,63;449518,3;DKK
22/02/2019;Dankort Panum Hovedkantine;-37,74;449560,93;DKK
22/02/2019;IZ *ANDERSEN, KOBENHAVN N;-130;449598,67;DKK
21/02/2019;Dankort Panum Hovedkantine;-40,84;449728,67;DKK
21/02/2019;Pengeautomat;-300;449769,51;DKK
20/02/2019;Dankort Flying Tiger Copen;-30;450069,51;DKK
20/02/2019;MobilePay: Maria Cam;50;450099,51;DKK
20/02/2019;Dankort Panum Hovedkantine;-34,49;450049,51;DKK
19/02/2019;Dankort Panum Hovedkantine;-41,23;450084;DKK
19/02/2019;IZ *A L I C E, KOBENHAVN S;-105;450125,23;DKK
18/02/2019;MobilePay: Theresia Schnurr;-20;450230,23;DKK
18/02/2019;Dankort Panum Hovedkantine;-38,44;450250,23;DKK
15/02/2019;Dankort Panum Hovedkantine;-36,81;450288,67;DKK
15/02/2019;Dankort Panum Hovedkantine;-35,88;450325,48;DKK
15/02/2019;VIROU IVS, FREDERIKSBERG;-85;450361,36;DKK
13/02/2019;Dankort Panum Hovedkantine;-37,59;450446,36;DKK
13/02/2019;RYANAIR, DUBLIN;-282;450483,95;DKK
12/02/2019;Dankort Panum Hovedkantine;-35,88;450765,95;DKK
11/02/2019;Dankort Flying Tiger Copen;-40;450801,83;DKK
11/02/2019;Dankort Panum Hovedkantine;-32,55;450841,83;DKK
08/02/2019;Dankort Panum Hovedkantine;-41,85;450874,38;DKK
07/02/2019;Dankort Panum Hovedkantine;-42,86;450916,23;DKK
07/02/2019;Dankort Panum Hovedkantine;-32,94;450959,09;DKK
07/02/2019;OISTER.DK, KOBENHAVN;-89;450992,03;DKK
07/02/2019;Dankort Coffee Factory Swe;-101;451081,03;DKK
05/02/2019;Dankort Panum Hovedkantine;-19,92;451182,03;DKK
05/02/2019;Pengeautomat;-200;451201,95;DKK
04/02/2019;Dankort Panum Hovedkantine;-42,47;451401,95;DKK
01/02/2019;FOF KØBENHAVN Nota 2906585;-145;451444,42;DKK
01/02/2019;Dankort Panum Hovedkantine;-32,16;451589,42;DKK
31/01/2019;Account 64970001000373;-10000;451621,58;DKK
31/01/2019;Københavns Universit;24393,54;461621,58;DKK
30/01/2019;HOTEL BARCELO SANTS, BARCELONA EUR 94,71;-714,29;437228,04;DKK
28/01/2019;MobilePay: Maria Cam;100;437942,33;DKK
28/01/2019;Dankort Panum Hovedkantine;-29,68;437842,33;DKK
28/01/2019;Dankort Rema 1000;-24,49;437872,01;DKK
28/01/2019;Dankort Gebr. Heinemann;-10;437896,5;DKK
28/01/2019;MobilePay: Patryk Fraczyk;-408;437906,5;DKK
25/01/2019;Dankort Panum Hovedkantine;-36,04;438314,5;DKK
24/01/2019;Dankort Panum Hovedkantine;-34,57;438350,54;DKK
23/01/2019;Dankort Mokkariet Odensega;-80;438385,11;DKK
23/01/2019;Dankort Panum Hovedkantine;-34,18;438465,11;DKK
22/01/2019;LEVI STRAUSS DENMARK,, Kbenhavn;-499;438499,29;DKK
21/01/2019;MobilePay køb Chartwells Kantinen hos Panum (DK589), B;-34,41;438998,29;DKK
21/01/2019;Dankort Kajakhotellet;-70;439032,7;DKK
21/01/2019;Dankort Empire Bio A/S;-42;439102,7;DKK
21/01/2019;Dankort Red Flag ApS;-455;439144,7;DKK
21/01/2019;Dankort Kaffebar;-150;439599,7;DKK
21/01/2019;Dankort Panum Hovedkantine;-35,11;439749,7;DKK
18/01/2019;Dankort Panum Hovedkantine;-35,65;439784,81;DKK
17/01/2019;Dankort Panum Hovedkantine;-39,91;439820,46;DKK
17/01/2019;Dankort Panum Hovedkantine;-35,11;439860,37;DKK
17/01/2019;IZ *ANDERSEN, KOBENHAVN N;-105;439895,48;DKK
15/01/2019;Dankort Panum Hovedkantine;-37,74;440000,48;DKK
14/01/2019;Stokkel;-350;440038,22;DKK
14/01/2019;Dankort Panum Hovedkantine;-41,62;440388,22;DKK
11/01/2019;Dankort Panum Hovedkantine;-40,92;440429,84;DKK
10/01/2019;Dankort Panum Hovedkantine;-36,19;440470,76;DKK
08/01/2019;Dankort Panum Hovedkantine;-32,24;440506,95;DKK
08/01/2019;GOB SKINCARE APS, KBENHAVN N;-200;440539,19;DKK
07/01/2019;Dankort Panum Hovedkantine;-44,02;440739,19;DKK
07/01/2019;MobilePay: Patryk Fraczyk;-220;440783,21;DKK
04/01/2019;Dankort Panum Hovedkantine;-34,41;441003,21;DKK
04/01/2019;OISTER.DK, KOBENHAVN;-99;441037,62;DKK
03/01/2019;Dankort Panum Hovedkantine;-32,24;441136,62;DKK
02/01/2019;Dankort Panum Hovedkantine;-40,3;441168,86;DKK
02/01/2019;AKADEMIKERNES A-KASSE;-1320;441209,16;DKK
31/12/2018;Rente af indestående;779,22;442529,16;DKK
28/12/2018;Account 64970001000373;-10000;441749,94;DKK
28/12/2018;Københavns Universit;25146,54;451749,94;DKK
27/12/2018;Firtal Web Aps Nota 940017963;-153;426603,4;DKK
27/12/2018;portal.postnord.co Nota C102749239;-54;426756,4;DKK
27/12/2018;DSB 677 Hot RKA;-200;426810,4;DKK
27/12/2018;MobilePay køb Bonsaihjørnet;-499;427010,4;DKK
27/12/2018;MobilePay køb Enggården - Frederiksberg;-300;427509,4;DKK
21/12/2018;Dankort Panum Hovedkantine;-42,47;427809,4;DKK
20/12/2018;Dankort Panum Hovedkantine;-37,36;427851,87;DKK
20/12/2018;Pengeautomat;-300;427889,23;DKK
19/12/2018;Dankort Panum Hovedkantine;-25;428189,23;DKK
19/12/2018;MobilePay: Karina Kaadtmann;-20;428214,23;DKK
18/12/2018;Dankort Panum Hovedkantine;-34,72;428234,23;DKK
17/12/2018;Dankort Panum Hovedkantine;-35,03;428268,95;DKK
17/12/2018;MobilePay: Camilla Verdich;-10;428303,98;DKK
17/12/2018;MobilePay køb Birkemosegaard Køkken;-140;428313,98;DKK
14/12/2018;Dankort Panum Hovedkantine;-39,84;428453,98;DKK
14/12/2018;Dankort Democratic Coffee;-80;428493,82;DKK
13/12/2018;Dankort Panum Hovedkantine;-38,28;428573,82;DKK
12/12/2018;Dankort Panum Hovedkantine;-25;428612,1;DKK
12/12/2018;Dankort Mokkariet Odensega;-76;428637,1;DKK
11/12/2018;Dankort Panum Hovedkantine;-34,1;428713,1;DKK
11/12/2018;MobilePay: Maria Camila Alvarez Silva;-10;428747,2;DKK
10/12/2018;Dankort Panum Hovedkantine;-25,26;428757,2;DKK
10/12/2018;Dankort REFFEN;-50;428782,46;DKK
10/12/2018;Dankort PAPYRUS BOGCAFE Ap;-65;428832,46;DKK
10/12/2018;Røverkøb A/S;-25;428897,46;DKK
07/12/2018;Dankort Netto 410;-82,95;428922,46;DKK
07/12/2018;Dankort Stigs oliven ApS;-70;429005,41;DKK
07/12/2018;Dankort Tapa Del Toro;-125;429075,41;DKK
07/12/2018;Dankort Panum Hovedkantine;-40,14;429200,41;DKK
06/12/2018;Dankort Panum Hovedkantine;-25;429240,55;DKK
06/12/2018;MobilePay: Annemette Forman;-20;429265,55;DKK
05/12/2018;MobilePay: Camilla Verdich;-150;429285,55;DKK
05/12/2018;Dankort Panum Hovedkantine;-36,42;429435,55;DKK
05/12/2018;MobilePay: Avirup Du;85;429471,97;DKK
05/12/2018;Dankort Mokkariet Odensega;-92;429386,97;DKK
04/12/2018;Dankort Panum Hovedkantine;-40,3;429478,97;DKK
04/12/2018;CAFE AMAZONIA, KOBENHAVN N;-796;429519,27;DKK
04/12/2018;IZ *FONDEN ESRUM K, GRAESTED;-150;430315,27;DKK
04/12/2018;OISTER.DK, KOBENHAVN;-99;430465,27;DKK
04/12/2018;IZ *FONDEN ESRUM K, GRAESTED;-70;430564,27;DKK
03/12/2018;Dankort Panum Hovedkantine;-41,08;430634,27;DKK
03/12/2018;KAFFEPLANTAGEN, KOBENHAVN N;-68;430675,35;DKK
03/12/2018;Dankort Hotel Chocolat Fre;-100;430743,35;DKK
03/12/2018;MobilePay: Sophia Me;105,5;430843,35;DKK
03/12/2018;MobilePay: Lam Opal;105,5;430737,85;DKK
03/12/2018;MobilePay: Asker Bre;104,5;430632,35;DKK
03/12/2018;MobilePay: Bettina L;106;430527,85;DKK
03/12/2018;MobilePay: Carmen Le;105;430421,85;DKK
03/12/2018;MobilePay: Carmen Le;105;430316,85;DKK
30/11/2018;Dankort Panum Hovedkantine;-35,18;430211,85;DKK
30/11/2018;Account 64970001000373;-10000;430247,03;DKK
30/11/2018;Københavns Universit;25146,54;440247,03;DKK
29/11/2018;Dankort Panum Hovedkantine;-34,1;415100,49;DKK
28/11/2018;Dankort Kaffebar;-60;415134,59;DKK
28/11/2018;Dankort Panum Hovedkantine;-36,58;415194,59;DKK
27/11/2018;Dankort Panum Hovedkantine;-37,51;415231,17;DKK
26/11/2018;Dankort Panum Hovedkantine;-34,72;415268,68;DKK
08/11/2018;Visa/Dankort JPY     5700 Kurs 5,8768 Nota nr. 35391 WEST JAPAN RAILWAY CO., OSAKA;-334,98;415303,4;DKK
07/11/2018;Visa/Dankort KontantGebyr Nota nr.;-30;415638,38;DKK
07/11/2018;JPY 30216;-1782,04;415668,38;DKK
06/11/2018;DKK 99,00;-99;417450,42;DKK
02/11/2018;Dankort Gebr. Heinemann;-18;417549,42;DKK
02/11/2018;POST DANMARK AS, KOEBENHAVN V;-255;417567,42;DKK
02/11/2018;Dankort Democratic Coffee;-22;417822,42;DKK
02/11/2018;Dankort PAPYRUS BOGCAFE Ap;-62;417844,42;DKK
01/11/2018;Dankort Panum Hovedkantine;-39,22;417906,42;DKK
31/10/2018;Account 64970001000373;-10000;417945,64;DKK
31/10/2018;Københavns Universit;19914,28;427945,64;DKK
30/10/2018;Dankort Panum Hovedkantine;-31,46;408031,36;DKK
30/10/2018;IZ *SOCIAL APS, KOBENHAVN N;-126;408062,82;DKK
30/10/2018;IZ *A L I C E, KOBENHAVN S;-110;408188,82;DKK
30/10/2018;HOTDOGDELI COPENHAGEN HO, KOEBENHA;-35;408298,82;DKK
30/10/2018;Pengeautomat;-300;408333,82;DKK
29/10/2018;Dankort Panum Hovedkantine;-41,23;408633,82;DKK
29/10/2018;billet.kglteaterdk Nota 1602185;-800;408675,05;DKK
29/10/2018;Dankort POLITIKEN Forhal;-639;409475,05;DKK
29/10/2018;Dankort Dry & Bitter ApS;-50;410114,05;DKK
29/10/2018;Dankort Bang & Jensen;-55;410164,05;DKK
26/10/2018;Dankort Panum Hovedkantine;-38,28;410219,05;DKK
26/10/2018;IZ *A L I C E, KOBENHAVN S;-110;410257,33;DKK
26/10/2018;IZ *A L I C E, Kobenhavn S;-35;410367,33;DKK
25/10/2018;Dankort Panum Hovedkantine;-34,41;410402,33;DKK
23/10/2018;Dankort Panum Hovedkantine;-33,79;410436,74;DKK
23/10/2018;Dankort beAwear;-79;410470,53;DKK
22/10/2018;Dankort Panum Hovedkantine;-25;410549,53;DKK
22/10/2018;Dankort Falafel Factory Ap;-77;410574,53;DKK
22/10/2018;Dankort Den Grønlandske Ha;-300;410651,53;DKK
22/10/2018;Mormors;-312;410951,53;DKK
19/10/2018;kontaktløs Dankort Panum Hovedkantine;-27,59;411263,53;DKK
19/10/2018;kontaktløs Dankort Rema 1000;-142,4;411291,12;DKK
19/10/2018;MobilePay: Henrik Jonsbak;-141;411433,52;DKK
19/10/2018;kontaktløs Dankort Democratic Coffee;-104;411574,52;DKK
18/10/2018;kontaktløs Dankort Panum Hovedkantine;-32,24;411678,52;DKK
17/10/2018;kontaktløs Dankort Panum Hovedkantine;-38,75;411710,76;DKK
16/10/2018;Dankort-køb CEWE Fotoservice;-105,4;411749,51;DKK
16/10/2018;kontaktløs Dankort Panum Hovedkantine;-28,98;411854,91;DKK
16/10/2018;IZ *A L I C E, KOBENHAVN S;-50;411883,89;DKK
15/10/2018;kontaktløs Dankort Panum Hovedkantine;-34,41;411933,89;DKK
15/10/2018;Dankort-køb KKB;-20;411968,3;DKK
15/10/2018;M Forum RVM;-300;411988,3;DKK
15/10/2018;Dankort fjællræven epic st;-2299;412288,3;DKK
15/10/2018;kontaktløs Dankort FREDERIKSBERG MATE;-69,95;414587,3;DKK
12/10/2018;kontaktløs Dankort Panum Hovedkantine;-36,27;414657,25;DKK
11/10/2018;MobilePay køb Mokkariet Odensegade,;-72;414693,52;DKK
11/10/2018;kontaktløs Dankort Panum Hovedkantine;-35,96;414765,52;DKK
11/10/2018;MobilePay: Christian Theil Have;-20;414801,48;DKK
11/10/2018;MobilePay: Jette Bork-Jensen;-20;414821,48;DKK
10/10/2018;kontaktløs Dankort Fazer Food Service;-36,83;414841,48;DKK
10/10/2018;kontaktløs Dankort Fazer Food Service;-15;414878,31;DKK
09/10/2018;kontaktløs Dankort Panum Hovedkantine;-25;414893,31;DKK
09/10/2018;Original Coffee Dossering, Koebenha;-69;414918,31;DKK
08/10/2018;kontaktløs Dankort Panum Hovedkantine;-39,37;414987,31;DKK
08/10/2018;MobilePay: Patryk Fraczyk;-70;415026,68;DKK
08/10/2018;MobilePay: Patryk Fraczyk;-120;415096,68;DKK
05/10/2018;kontaktløs Dankort Panum Hovedkantine;-39,84;415216,68;DKK
04/10/2018;kontaktløs Dankort Panum Hovedkantine;-40,3;415256,52;DKK
04/10/2018;OISTER.DK, KOBENHAVN;-99;415296,82;DKK
03/10/2018;Panum Hovedkantine;-38,9;415395,82;DKK
03/10/2018;MobilePay: Camilla Verdich;-20;415434,72;DKK
02/10/2018;kontaktløs Dankort Panum Hovedkantine;-40,3;415454,72;DKK
01/10/2018;kontaktløs Dankort Panum Hovedkantine;-35,96;415495,02;DKK
01/10/2018;AKADEMIKERNES A-KASSE;-1308;415530,98;DKK
01/10/2018;kontaktløs Dankort Pizzeria;-55;416838,98;DKK
01/10/2018;kontaktløs Dankort VAP Danmark II ApS;-173;416893,98;DKK
01/10/2018;kontaktløs Dankort Dalle Valle;-110;417066,98;DKK
28/09/2018;kontaktløs Dankort Panum Hovedkantine;-32,7;417176,98;DKK
28/09/2018;Account 64970001000373;-10000;417209,68;DKK
28/09/2018;Københavns Universit;25036,1;427209,68;DKK
28/09/2018;Overførsel;4469,83;402173,58;DKK
27/09/2018;kontaktløs Dankort Panum Hovedkantine;-34,56;397703,75;DKK
26/09/2018;kontaktløs Dankort Panum Hovedkantine;-39,22;397738,31;DKK
25/09/2018;kontaktløs Dankort Panum Hovedkantine;-39,37;397777,53;DKK
24/09/2018;kontaktløs Dankort Panum Hovedkantine;-25;397816,9;DKK
24/09/2018;kontaktløs Dankort Democratic Coffee;-67;397841,9;DKK
24/09/2018;kontaktløs Dankort The Coffee Collect;-65;397908,9;DKK
21/09/2018;kontaktløs Dankort Panum Hovedkantine;-36,58;397973,9;DKK
21/09/2018;MobilePay: Emilie Glad Bak;-20;398010,48;DKK
21/09/2018;DB AUTOMATEN, Heidelberg EUR 27,50;-207,26;398030,48;DKK
20/09/2018;kontaktløs Dankort Panum Hovedkantine;-31,78;398237,74;DKK
19/09/2018;MobilePay: Maria Cam;22;398269,52;DKK
19/09/2018;Visa/Dankort KontantGebyr Nota nr.;-30;398247,52;DKK
19/09/2018;COMMERZBANK ATM, HEIDELBERG EUR 50,00;-376,84;398277,52;DKK
19/09/2018;MobilePay: Emilie Gl;34;398654,36;DKK
18/09/2018;MobilePay: Maria Cam;34;398620,36;DKK
18/09/2018;MobilePay: Carmen Le;34;398586,36;DKK
18/09/2018;Holiday Inn Express Heide, Heidelbe EUR 476,00;-3587,07;398552,36;DKK
18/09/2018;DB AUTOMATEN, Frankfurt am EUR 24,50;-184,63;402139,43;DKK
18/09/2018;MOB.PAY*H.C. FRISOR, KOBENHAVN K;-140;402324,06;DKK
17/09/2018;kontaktløs Dankort Pret A Manger T2 A;-58;402464,06;DKK
14/09/2018;kontaktløs Dankort Panum Hovedkantine;-37,04;402522,06;DKK
14/09/2018;kontaktløs Dankort Kaffeplantagen ApS;-28;402559,1;DKK
13/09/2018;kontaktløs Dankort Panum Hovedkantine;-39,06;402587,1;DKK
12/09/2018;kontaktløs Dankort Panum Hovedkantine;-38,9;402626,16;DKK
11/09/2018;kontaktløs Dankort Panum Hovedkantine;-38,13;402665,06;DKK
11/09/2018;HOOHA APS, KBENHAVN;-400;402703,19;DKK
11/09/2018;GOB SKINCARE APS, KBENHAVN N;-200;403103,19;DKK
10/09/2018;kontaktløs Dankort Banh Mi Kim;-56;403303,19;DKK
10/09/2018;kontaktløs Dankort Panum Hovedkantine;-37,51;403359,19;DKK
07/09/2018;kontaktløs Dankort Panum Hovedkantine;-38,28;403396,7;DKK
06/09/2018;MobilePay: Annemette Forman;-20;403434,98;DKK
06/09/2018;kontaktløs Dankort Panum Hovedkantine;-36,58;403454,98;DKK
05/09/2018;kontaktløs Dankort Panum Hovedkantine;-35,65;403491,56;DKK
05/09/2018;kontaktløs Dankort Kaffebar;-189;403527,21;DKK
04/09/2018;Panum Hovedkantine;-33,64;403716,21;DKK
04/09/2018;OISTER.DK, KOBENHAVN;-99;403749,85;DKK
03/09/2018;kontaktløs Dankort Panum Hovedkantine;-33,64;403848,85;DKK
03/09/2018;kontaktløs Dankort AFRICAN TOUCH ApS;-139;403882,49;DKK
31/08/2018;kontaktløs Dankort Panum Hovedkantine;-34,72;404021,49;DKK
31/08/2018;Københavns Universit;25036,1;404056,21;DKK
31/08/2018;Account 64970001000373;-10000;379020,11;DKK
30/08/2018;kontaktløs Dankort Panum Hovedkantine;-34,41;389020,11;DKK
29/08/2018;kontaktløs Dankort Panum Hovedkantine;-37,04;389054,52;DKK
28/08/2018;kontaktløs Dankort Panum Hovedkantine;-23,87;389091,56;DKK
28/08/2018;kontaktløs Dankort Espresso House7136;-82;389115,43;DKK
27/08/2018;kontaktløs Dankort Rema 1000;-84,2;389197,43;DKK
27/08/2018;kontaktløs Dankort Panum Hovedkantine;-37,51;389281,63;DKK
24/08/2018;kontaktløs Dankort Panum Hovedkantine;-34,56;389319,14;DKK
23/08/2018;kontaktløs Dankort Panum Hovedkantine;-39,06;389353,7;DKK
22/08/2018;kontaktløs Dankort Panum Hovedkantine;-33,79;389392,76;DKK
21/08/2018;kontaktløs Dankort Panum Hovedkantine;-38,44;389426,55;DKK
20/08/2018;kontaktløs Dankort Panum Hovedkantine;-28,52;389464,99;DKK
20/08/2018;OISTER.DK, KOBENHAVN;-194,1;389493,51;DKK
17/08/2018;kontaktløs Dankort Panum Hovedkantine;-43,4;389687,61;DKK
16/08/2018;kontaktløs Dankort Panum Hovedkantine;-45,72;389731,01;DKK
15/08/2018;Café La Esquina Ap;-149;389776,73;DKK
15/08/2018;kontaktløs Dankort Panum Hovedkantine;-38,75;389925,73;DKK
14/08/2018;kontaktløs Dankort Panum Hovedkantine;-41,08;389964,48;DKK
13/08/2018;kontaktløs Dankort Panum Hovedkantine;-32,7;390005,56;DKK
13/08/2018;kontaktløs Dankort DET FRANSKE CONDIT;-35;390038,26;DKK
13/08/2018;DSB 626 Kh RKA;-200;390073,26;DKK
10/08/2018;kontaktløs Dankort Panum Hovedkantine;-39,06;390273,26;DKK
09/08/2018;kontaktløs Dankort Panum Hovedkantine;-35,34;390312,32;DKK
08/08/2018;kontaktløs Dankort Panum Hovedkantine;-31;390347,66;DKK
07/08/2018;kontaktløs Dankort Panum Hovedkantine;-36,27;390378,66;DKK
07/08/2018;OISTER.DK, KOBENHAVN;-113,45;390414,93;DKK
07/08/2018;IZ *A L I C E, KOBENHAVN S;-70;390528,38;DKK
07/08/2018;kontaktløs Dankort Aldi 002;-28,9;390598,38;DKK
06/08/2018;kontaktløs Dankort Banh Mi Kim;-82;390627,28;DKK
06/08/2018;OISTER.DK, KOBENHAVN;-99;390709,28;DKK
06/08/2018;kontaktløs Dankort VAP Danmark II ApS;-179;390808,28;DKK
02/08/2018;kontaktløs Dankort Panum Hovedkantine;-36,58;390987,28;DKK
01/08/2018;kontaktløs Dankort Panum Hovedkantine;-33,17;391023,86;DKK
31/07/2018;F'Eta Kai Eli'Es v;-130;391057,03;DKK
31/07/2018;kontaktløs Dankort Panum Hovedkantine;-31,16;391187,03;DKK
31/07/2018;Account 64970001000373;-10000;391218,19;DKK
31/07/2018;IZ *A L I C E, KOBENHAVN S;-35;401218,19;DKK
31/07/2018;Københavns Universit;25036,1;401253,19;DKK
30/07/2018;kontaktløs Dankort Panum Hovedkantine;-39,84;376217,09;DKK
30/07/2018;kontaktløs Dankort Lidl;-68,9;376256,93;DKK
30/07/2018;kontaktløs Dankort Fakta Strandlodsve;-140,35;376325,83;DKK
27/07/2018;kontaktløs Dankort Banh Mi Kim;-56;376466,18;DKK
26/07/2018;kontaktløs Dankort Panum Hovedkantine;-35,03;376522,18;DKK
25/07/2018;Straksoverførsel gennemført  pr. 25-07-2018/for lille lan;-15000;376557,21;DKK
25/07/2018;kontaktløs Dankort Panum Hovedkantine;-25;391557,21;DKK
24/07/2018;Panum Hovedkantine;-33,02;391582,21;DKK
23/07/2018;kontaktløs Dankort Panum Hovedkantine;-39,84;391615,23;DKK
23/07/2018;kontaktløs Dankort F'Eta Kai Eli'Es v;-120;391655,07;DKK
20/07/2018;kontaktløs Dankort Panum Hovedkantine;-30,84;391775,07;DKK
19/07/2018;kontaktløs Dankort Panum Hovedkantine;-33,79;391805,91;DKK
18/07/2018;kontaktløs Dankort Panum Hovedkantine;-37,51;391839,7;DKK
18/07/2018;kontaktløs Dankort Picnic;-28;391877,21;DKK
17/07/2018;kontaktløs Dankort Panum Hovedkantine;-39,99;391905,21;DKK
17/07/2018;IZ *A L I C E, KOBENHAVN S;-60;391945,2;DKK
16/07/2018;kontaktløs Dankort Panum Hovedkantine;-44,8;392005,2;DKK
16/07/2018;IZ *ANDERSEN, KOBENHAVN N;-145;392050;DKK
16/07/2018;kontaktløs Dankort Føtex Food Krøyers;-25;392195;DKK
13/07/2018;kontaktløs Dankort Panum Hovedkantine;-35,5;392220;DKK
12/07/2018;kontaktløs Dankort Panum Hovedkantine;-43,86;392255,5;DKK
11/07/2018;kontaktløs Dankort Panum Hovedkantine;-36,89;392299,36;DKK
10/07/2018;kontaktløs Dankort Panum Hovedkantine;-35,8;392336,25;DKK
10/07/2018;LEVI STRAUSS DENMARK,, Kbenhavn;-1000;392372,05;DKK
09/07/2018;kontaktløs Dankort Panum Hovedkantine;-42,16;393372,05;DKK
06/07/2018;kontaktløs Dankort Panum Hovedkantine;-33,64;393414,21;DKK
05/07/2018;kontaktløs Dankort Panum Hovedkantine;-37,51;393447,85;DKK
04/07/2018;kontaktløs Dankort Panum Hovedkantine;-18,76;393485,36;DKK
04/07/2018;OISTER.DK, KOBENHAVN;-99;393504,12;DKK
04/07/2018;MobilePay: Lam Opal;20;393603,12;DKK
04/07/2018;kontaktløs Dankort Old Irish Pub;-150;393583,12;DKK
03/07/2018;kontaktløs Dankort Panum Hovedkantine;-41,85;393733,12;DKK
03/07/2018;HOOHA V HENRIK KNUDSEN, KBENHAVN N;-300;393774,97;DKK
02/07/2018;kontaktløs Dankort Panum Hovedkantine;-35,18;394074,97;DKK
02/07/2018;AKADEMIKERNES A-KASSE;-1308;394110,15;DKK
02/07/2018;kontaktløs Dankort Banh Mi Kim;-56;395418,15;DKK
02/07/2018;kontaktløs Dankort ISoBar;-70;395474,15;DKK
29/06/2018;kontaktløs Dankort Panum Hovedkantine;-44,18;395544,15;DKK
29/06/2018;Account 64970001000373;-10000;395588,33;DKK
29/06/2018;Københavns Universit;14666,21;405588,33;DKK
28/06/2018;kontaktløs Dankort Panum Hovedkantine;-40,92;390922,12;DKK
27/06/2018;kontaktløs Dankort Panum Hovedkantine;-37,82;390963,04;DKK
26/06/2018;kontaktløs Dankort Panum Hovedkantine;-31,78;391000,86;DKK
25/06/2018;kontaktløs Dankort Panum Hovedkantine;-44,18;391032,64;DKK
25/06/2018;kontaktløs Dankort Pub & Sport;-30;391076,82;DKK
25/06/2018;kontaktløs Dankort Pub & Sport;-115;391106,82;DKK
22/06/2018;kontaktløs Dankort Panum Hovedkantine;-39,68;391221,82;DKK
22/06/2018;kontaktløs Dankort DET FRANSKE CONDIT;-153;391261,5;DKK
22/06/2018;kontaktløs Dankort Rema 1000;-117,75;391414,5;DKK
21/06/2018;Panum Hovedkantine;-41,23;391532,25;DKK
20/06/2018;kontaktløs Dankort Panum Hovedkantine;-44,8;391573,48;DKK
19/06/2018;kontaktløs Dankort Panum Hovedkantine;-35,03;391618,28;DKK
18/06/2018;kontaktløs Dankort Nørrebro Apotek v/;-47,95;391653,31;DKK
18/06/2018;kontaktløs Dankort Panum Hovedkantine;-40,76;391701,26;DKK
18/06/2018;Straksoverførsel gennemført  pr. 17-06-2018/start boligkonto, rest vienna;-42500;391742,02;DKK
15/06/2018;kontaktløs Dankort Q8 Service - 8063;-89;434242,02;DKK
15/06/2018;MobilePay: Timo Seba;30;434331,02;DKK
14/06/2018;kontaktløs Dankort Panum Hovedkantine;-33,79;434301,02;DKK
13/06/2018;kontaktløs Dankort Panum Hovedkantine;-36,42;434334,81;DKK
12/06/2018;kontaktløs Dankort Panum Hovedkantine;-39,52;434371,23;DKK
12/06/2018;GOB SKINCARE APS, KBENHAVN N;-150;434410,75;DKK
11/06/2018;kontaktløs Dankort Panum Hovedkantine;-43,4;434560,75;DKK
08/06/2018;kontaktløs Dankort Panum Hovedkantine;-38,75;434604,15;DKK
07/06/2018;kontaktløs Dankort Panum Hovedkantine;-40,46;434642,9;DKK
06/06/2018;kontaktløs Dankort Panum Hovedkantine;-37,51;434683,36;DKK
06/06/2018;OISTER.DK, KOBENHAVN;-89;434720,87;DKK
06/06/2018;PARKMAN, 358942579290;-14;434809,87;DKK
06/06/2018;kontaktløs Dankort Banh Mi Kim;-56;434823,87;DKK
04/06/2018;kontaktløs Dankort Panum Hovedkantine;-35,5;434879,87;DKK
31/05/2018;Account 64970001000373;-9000;434915,37;DKK
31/05/2018;Københavns Universit;24305,16;443915,37;DKK
25/05/2018;DSB 646 Kn RKA;-200;419610,21;DKK
24/05/2018;kontaktløs Dankort Panum Hovedkantine;-39,84;419810,21;DKK
23/05/2018;kontaktløs Dankort Lihns Skomageri;-58;419850,05;DKK
23/05/2018;kontaktløs Dankort Panum Hovedkantine;-41,08;419908,05;DKK
22/05/2018;kontaktløs Dankort Panum Hovedkantine;-36,74;419949,13;DKK
18/05/2018;kontaktløs Dankort Panum Hovedkantine;-33,64;419985,87;DKK
17/05/2018;kontaktløs Dankort Panum Hovedkantine;-34,1;420019,51;DKK
16/05/2018;kontaktløs Dankort Panum Hovedkantine;-36,89;420053,61;DKK
16/05/2018;MobilePay: Line Engelbrechtsen;-20;420090,5;DKK
15/05/2018;MobilePay køb Vildglad;-98;420110,5;DKK
15/05/2018;kontaktløs Dankort Café Valentin;-430;420208,5;DKK
15/05/2018;HANSEN S ISBAR OG CAFE, LISELEJE;-200;420638,5;DKK
15/05/2018;OISTER.DK, KOBENHAVN;-112,05;420838,5;DKK
15/05/2018;Pengeautomat;-700;420950,55;DKK
15/05/2018;Pengeautomat;-400;421650,55;DKK
15/05/2018;Dudes;-371;422050,55;DKK
14/05/2018;MobilePay: Mikkel;-550;422421,55;DKK
14/05/2018;MobilePay: Elin Pedersen;-4000;422971,55;DKK
14/05/2018;MobilePay køb bellona restaurant;-1369;426971,55;DKK
14/05/2018;kontaktløs Dankort PAPYRUS BOGCAFE Ap;-148;428340,55;DKK
09/05/2018;MobilePay køb M?O?D;-200;428488,55;DKK
09/05/2018;kontaktløs Dankort Panum Hovedkantine;-35,03;428688,55;DKK
08/05/2018;kontaktløs Dankort Panum Hovedkantine;-39,37;428723,58;DKK
07/05/2018;kontaktløs Dankort Irma Torvegade 58;-40;428762,95;DKK
07/05/2018;kontaktløs Dankort Panum Hovedkantine;-38,9;428802,95;DKK
07/05/2018;kontaktløs Dankort Democratic Coffee;-44;428841,85;DKK
07/05/2018;kontaktløs Dankort Kajakhotellet;-30;428885,85;DKK
07/05/2018;MobilePay: Maria Cam;120;428915,85;DKK
07/05/2018;kontaktløs Dankort Sweet Treat;-34;428795,85;DKK
04/05/2018;kontaktløs Dankort Øbro Hallen;-360;428829,85;DKK
04/05/2018;kontaktløs Dankort MENY;-23;429189,85;DKK
04/05/2018;kontaktløs Dankort Panum Hovedkantine;-44,02;429212,85;DKK
04/05/2018;OISTER.DK, KOBENHAVN;-89;429256,87;DKK
03/05/2018;kontaktløs Dankort Panum Hovedkantine;-40,14;429345,87;DKK
02/05/2018;kontaktløs Dankort Panum Hovedkantine;-45,1;429386,01;DKK
01/05/2018;MobilePay køb Leks Thai Food - Catering;-60;429431,11;DKK
01/05/2018;IZ *NICECREAMCPH I, KOBENHAVN V;-98;429491,11;DKK
01/05/2018;Pengeautomat;-300;429589,11;DKK
30/04/2018;kontaktløs Dankort Panum Hovedkantine;-36,58;429889,11;DKK
30/04/2018;Account 64970001000373;-9000;429925,69;DKK
30/04/2018;MobilePay køb Espressobar;-53;438925,69;DKK
30/04/2018;kontaktløs Dankort Kluns;-59;438978,69;DKK
30/04/2018;MobilePay: Isao Suzuki;-240;439037,69;DKK
30/04/2018;Københavns Universit;24305,16;439277,69;DKK
26/04/2018;kontaktløs Dankort HANS HJULMAND TAND;-570,69;414972,53;DKK
26/04/2018;kontaktløs Dankort Panum Hovedkantine;-37,98;415543,22;DKK
26/04/2018;kontaktløs Dankort Rema 1000;-82,85;415581,2;DKK
25/04/2018;Panum Hovedkantine;-41,38;415664,05;DKK
25/04/2018;Overførsel;1127,64;415705,43;DKK
24/04/2018;kontaktløs Dankort Panum Hovedkantine;-36,27;414577,79;DKK
23/04/2018;kontaktløs Dankort Panum Hovedkantine;-31,78;414614,06;DKK
20/04/2018;kontaktløs Dankort Gebr. Heinemann;-18;414645,84;DKK
20/04/2018;kontaktløs Dankort Panum Hovedkantine;-44,8;414663,84;DKK
19/04/2018;MobilePay køb Vildglad;-69;414708,64;DKK
19/04/2018;kontaktløs Dankort Panum Hovedkantine;-35,18;414777,64;DKK
18/04/2018;MobilePay: Dennis KellerSchnabelrauch;-650;414812,82;DKK
18/04/2018;kontaktløs Dankort Panum Hovedkantine;-37,04;415462,82;DKK
17/04/2018;kontaktløs Dankort Panum Hovedkantine;-41,08;415499,86;DKK
16/04/2018;kontaktløs Dankort Panum Hovedkantine;-41,54;415540,94;DKK
16/04/2018;kontaktløs Dankort Báhn Mì Daily // T;-72;415582,48;DKK
13/04/2018;kontaktløs Dankort Panum Hovedkantine;-46,34;415654,48;DKK
12/04/2018;kontaktløs Dankort Panum Hovedkantine;-41,85;415700,82;DKK
11/04/2018;kontaktløs Dankort Panum Hovedkantine;-30;415742,67;DKK
10/04/2018;kontaktløs Dankort Panum Hovedkantine;-37,51;415772,67;DKK
10/04/2018;IZ *FIESTA CATERIN, KOBENHAVN O;-470;415810,18;DKK
10/04/2018;OVERSKYDENDE SKAT;679;416280,18;DKK
09/04/2018;kontaktløs Dankort Panum Hovedkantine;-53,48;415601,18;DKK
09/04/2018;kontaktløs Dankort FREDERIKSBERG CHOK;-150;415654,66;DKK
09/04/2018;kontaktløs Dankort Brus ApS;-60;415804,66;DKK
06/04/2018;kontaktløs Dankort Panum Hovedkantine;-44,48;415864,66;DKK
05/04/2018;kontaktløs Dankort Panum Hovedkantine;-41,08;415909,14;DKK
04/04/2018;MobilePay: Susanne Møller-Hansen;-600;415950,22;DKK
04/04/2018;MobilePay: Susanne Møller-Hansen;-600;416550,22;DKK
04/04/2018;kontaktløs Dankort Panum Hovedkantine;-43,09;417150,22;DKK
04/04/2018;OISTER.DK, KOBENHAVN;-89;417193,31;DKK
03/04/2018;kontaktløs Dankort Panum Hovedkantine;-35,96;417282,31;DKK
03/04/2018;AKADEMIKERNES A-KASSE;-1308;417318,27;DKK
28/03/2018;kontaktløs Dankort Panum Hovedkantine;-44,48;418626,27;DKK
28/03/2018;Account 64970001000373;-9000;418670,75;DKK
28/03/2018;Københavns Universit;24305,16;427670,75;DKK
27/03/2018;kontaktløs Dankort Panum Hovedkantine;-25;403365,59;DKK
26/03/2018;kontaktløs Dankort Panum Hovedkantine;-38,75;403390,59;DKK
26/03/2018;kontaktløs Dankort KØBENHAVN STENO AP;-84,75;403429,34;DKK
23/03/2018;kontaktløs Dankort Panum Hovedkantine;-25;403514,09;DKK
22/03/2018;kontaktløs Dankort Panum Hovedkantine;-37,82;403539,09;DKK
21/03/2018;kontaktløs Dankort Panum Hovedkantine;-33,94;403576,91;DKK
20/03/2018;kontaktløs Dankort Panum Hovedkantine;-43,4;403610,85;DKK
19/03/2018;kontaktløs Dankort Panum Hovedkantine;-48,52;403654,25;DKK
19/03/2018;kontaktløs Dankort Sticks N Sushi;-700;403702,77;DKK
19/03/2018;MobilePay: Patryk Fr;350;404402,77;DKK
19/03/2018;Dankort-køb BS Pay app;-100;404052,77;DKK
19/03/2018;M Forum RVM;-200;404152,77;DKK
16/03/2018;kontaktløs Dankort Panum Hovedkantine;-40,92;404352,77;DKK
15/03/2018;kontaktløs Dankort Panum Hovedkantine;-43,86;404393,69;DKK
14/03/2018;kontaktløs Dankort Panum Hovedkantine;-47,12;404437,55;DKK
14/03/2018;Københavns Universit;70430,25;404484,67;DKK
13/03/2018;kontaktløs Dankort Panum Hovedkantine;-55,18;334054,42;DKK
12/03/2018;kontaktløs Dankort FREDERIKSBERG MATE;-49,95;334109,6;DKK
12/03/2018;kontaktløs Dankort Panum Hovedkantine;-45,72;334159,55;DKK
09/03/2018;kontaktløs Dankort Panum Hovedkantine;-44,64;334205,27;DKK
08/03/2018;Panum Hovedkantine;-49,29;334249,91;DKK
07/03/2018;kontaktløs Dankort Panum Hovedkantine;-46,96;334299,2;DKK
06/03/2018;kontaktløs Dankort Panum Hovedkantine;-42,62;334346,16;DKK
06/03/2018;OISTER.DK, KOBENHAVN;-89;334388,78;DKK
05/03/2018;kontaktløs Dankort Panum Hovedkantine;-49,44;334477,78;DKK
05/03/2018;MobilePay køb;-200;334527,22;DKK
02/03/2018;MobilePay: Timo Sebastian Kern;-50;334727,22;DKK
02/03/2018;kontaktløs Dankort Panum Hovedkantine;-47,9;334777,22;DKK
01/03/2018;kontaktløs Dankort Panum Hovedkantine;-38,9;334825,12;DKK
28/02/2018;Account 64970001000373;-9000;334864,02;DKK
28/02/2018;Københavns Universit;25955,14;343864,02;DKK
23/02/2018;kontaktløs Dankort Panum Hovedkantine;-46,19;317908,88;DKK
22/02/2018;kontaktløs Dankort Panum Hovedkantine;-53,94;317955,07;DKK
22/02/2018;kontaktløs Dankort August Krogh Insti;-35,7;318009,01;DKK
21/02/2018;MobilePay: Trine Friis Toldsted;-20;318044,71;DKK
21/02/2018;MobilePay: Jutta Bulkescher;-300;318064,71;DKK
21/02/2018;kontaktløs Dankort August Krogh Insti;-36,98;318364,71;DKK
20/02/2018;Original Coffee, Koebenhavn k;-110;318401,69;DKK
19/02/2018;kontaktløs Dankort Panum Hovedkantine;-46,5;318511,69;DKK
16/02/2018;kontaktløs Dankort Panum Hovedkantine;-40,3;318558,19;DKK
16/02/2018;HOOHA V. HENRIK KNUDSEN , KOBENHAV;-500;318598,49;DKK
16/02/2018;GOB SKINCARE APS, KOBENHAVN N;-200;319098,49;DKK
15/02/2018;kontaktløs Dankort Panum Hovedkantine;-25;319298,49;DKK
15/02/2018;Pengeautomat;-300;319323,49;DKK
13/02/2018;kontaktløs Dankort Panum Hovedkantine;-52,39;319623,49;DKK
12/02/2018;kontaktløs Dankort Panum Hovedkantine;-45,1;319675,88;DKK
12/02/2018;MobilePay: Patryk Fr;140;319720,98;DKK
09/02/2018;Dankort-køb Ticketmaster DK;-116,65;319580,98;DKK
09/02/2018;kontaktløs Dankort Panum Hovedkantine;-46,81;319697,63;DKK
09/02/2018;FÆTTER FÆTTER A, KØBENHAVN N;-140;319744,44;DKK
08/02/2018;kontaktløs Dankort Panum Hovedkantine;-25;319884,44;DKK
07/02/2018;kontaktløs Dankort Panum Hovedkantine;-48,2;319909,44;DKK
06/02/2018;kontaktløs Dankort Panum Hovedkantine;-35,65;319957,64;DKK
06/02/2018;OISTER.DK, KOBENHAVN;-89;319993,29;DKK
05/02/2018;kontaktløs Dankort Panum Hovedkantine;-41,7;320082,29;DKK
02/02/2018;kontaktløs Dankort Panum Hovedkantine;-25;320123,99;DKK
01/02/2018;kontaktløs Dankort Panum Hovedkantine;-39,99;320148,99;DKK
31/01/2018;kontaktløs Dankort Panum Hovedkantine;-38,13;320188,98;DKK
31/01/2018;Københavns Universit;25955,14;320227,11;DKK
31/01/2018;Account 64970001000373;-9000;294271,97;DKK
30/01/2018;kontaktløs Dankort Panum Hovedkantine;-38,9;303271,97;DKK
29/01/2018;Panum Hovedkantine;-33,17;303310,87;DKK
23/01/2018;kontaktløs Dankort Panum Hovedkantine;-35,65;303344,04;DKK
22/01/2018;kontaktløs Dankort Panum Hovedkantine;-38,75;303379,69;DKK
22/01/2018;kontaktløs Dankort Parterre;-120;303418,44;DKK
22/01/2018;kontaktløs Dankort Parterre;-35;303538,44;DKK
19/01/2018;kontaktløs Dankort Panum Hovedkantine;-25;303573,44;DKK
18/01/2018;kontaktløs Dankort Panum Hovedkantine;-34,1;303598,44;DKK
17/01/2018;kontaktløs Dankort Panum Hovedkantine;-41,08;303632,54;DKK
16/01/2018;kontaktløs Dankort Panum Hovedkantine;-40,61;303673,62;DKK
15/01/2018;kontaktløs Dankort Panum Hovedkantine;-40,14;303714,23;DKK
15/01/2018;Dankort-køb MobilePay;-66;303754,37;DKK
12/01/2018;kontaktløs Dankort Panum Hovedkantine;-43,09;303820,37;DKK
11/01/2018;kontaktløs Dankort Panum Hovedkantine;-25;303863,46;DKK
10/01/2018;kontaktløs Dankort Panum Hovedkantine;-40,46;303888,46;DKK
08/01/2018;kontaktløs Dankort Panum Hovedkantine;-40,46;303928,92;DKK
05/01/2018;kontaktløs Dankort Panum Hovedkantine;-38,75;303969,38;DKK
04/01/2018;kontaktløs Dankort Panum Hovedkantine;-33,79;304008,13;DKK
04/01/2018;OISTER.DK, KOBENHAVN;-89;304041,92;DKK
03/01/2018;kontaktløs Dankort Panum Hovedkantine;-33,32;304130,92;DKK
02/01/2018;kontaktløs Dankort Panum Hovedkantine;-28,83;304164,24;DKK
02/01/2018;AKADEMIKERNES A-KASSE;-1308;304193,07;DKK
02/01/2018;2189690;-100;305501,07;DKK
31/12/2017;Rente af indestående;437,19;305601,07;DKK
29/12/2017;Account 64970001000373;-9000;305163,88;DKK
29/12/2017;Københavns Universit;24637,14;314163,88;DKK
28/12/2017;kontaktløs Dankort Panum Hovedkantine;-41,85;289526,74;DKK
28/12/2017;Pengeautomat;-300;289568,59;DKK
27/12/2017;kontaktløs Dankort Panum Hovedkantine;-49,76;289868,59;DKK
27/12/2017;M Forum RVM;-200;289918,35;DKK
27/12/2017;kontaktløs Dankort Rema 1000;-79;290118,35;DKK
27/12/2017;kontaktløs Dankort AFRICAN TOUCH ApS;-170;290197,35;DKK
22/12/2017;kontaktløs Dankort Panum Hovedkantine;-36,27;290367,35;DKK
22/12/2017;Dankort-køb knowledgecottonapp;-1197;290403,62;DKK
21/12/2017;Panum Hovedkantine;-37,2;291600,62;DKK
21/12/2017;2189690;-200;291637,82;DKK
21/12/2017;Dankort-køb MobilePay;-900;291837,82;DKK
20/12/2017;kontaktløs Dankort Panum Hovedkantine;-42,47;292737,82;DKK
19/12/2017;SHABAZ PANUM, KOBENHAVN N;-62;292780,29;DKK
19/12/2017;kontaktløs Dankort August Krogh Insti;-30,6;292842,29;DKK
19/12/2017;Dankort-køb Ticketmaster DK;-631,64;292872,89;DKK
18/12/2017;Dankort-køb MobilePay;-45;293504,53;DKK
18/12/2017;kontaktløs Dankort FREDERIKSBERG CHOK;-155;293549,53;DKK
18/12/2017;kontaktløs Dankort gågrøn!;-49;293704,53;DKK
18/12/2017;Dankort-køb MobilePay;-50;293753,53;DKK
18/12/2017;Dankort-køb MobilePay;-20;293803,53;DKK
14/12/2017;kontaktløs Dankort Panum Hovedkantine;-41,38;293823,53;DKK
14/12/2017;kontaktløs Dankort Netto Park;-29,95;293864,91;DKK
13/12/2017;kontaktløs Dankort Panum Hovedkantine;-40,3;293894,86;DKK
12/12/2017;kontaktløs Dankort Panum Hovedkantine;-35,96;293935,16;DKK
11/12/2017;kontaktløs Dankort Panum Hovedkantine;-28,52;293971,12;DKK
11/12/2017;Dankort-køb MobilePay;-170;293999,64;DKK
11/12/2017;Dankort-køb MobilePay;-480;294169,64;DKK
08/12/2017;kontaktløs Dankort Panum Hovedkantine;-33,64;294649,64;DKK
07/12/2017;kontaktløs Dankort Panum Hovedkantine;-34,56;294683,28;DKK
06/12/2017;kontaktløs Dankort Rema 1000;-98,25;294717,84;DKK
06/12/2017;Dankort-køb MobilePay;-20;294816,09;DKK
06/12/2017;Dankort-køb MobilePay;-20;294836,09;DKK
06/12/2017;Dankort-køb MobilePay;-20;294856,09;DKK
06/12/2017;kontaktløs Dankort Panum Hovedkantine;-43,56;294876,09;DKK
05/12/2017;kontaktløs Dankort Panum Hovedkantine;-37,04;294919,65;DKK
05/12/2017;OISTER.DK, KOBENHAVN;-89;294956,69;DKK
04/12/2017;kontaktløs Dankort Panum Hovedkantine;-43,71;295045,69;DKK
04/12/2017;THE SOUTH INDIAN APS, FREDERIKSBERG;-196;295089,4;DKK
01/12/2017;kontaktløs Dankort Panum Hovedkantine;-32,7;295285,4;DKK
30/11/2017;kontaktløs Dankort Panum Hovedkantine;-36,42;295318,1;DKK
30/11/2017;Københavns Universit;24291,88;295354,52;DKK
30/11/2017;Account 64970001000373;-9000;271062,64;DKK
29/11/2017;kontaktløs Dankort Panum Hovedkantine;-42;280062,64;DKK
28/11/2017;kontaktløs Dankort Panum Hovedkantine;-42,47;280104,64;DKK
27/11/2017;kontaktløs Dankort Panum Hovedkantine;-35,65;280147,11;DKK
27/11/2017;Dankort-køb MobilePay;-3375;280182,76;DKK
24/11/2017;kontaktløs Dankort Panum Hovedkantine;-34,56;283557,76;DKK
23/11/2017;kontaktløs Dankort Øbro Hallen;-360;283592,32;DKK
23/11/2017;kontaktløs Dankort Panum Hovedkantine;-35,96;283952,32;DKK
23/11/2017;Dankort-køb MobilePay;-20;283988,28;DKK
22/11/2017;kontaktløs Dankort Panum Hovedkantine;-35,96;284008,28;DKK
21/11/2017;kontaktløs Dankort Panum Hovedkantine;-43,56;284044,24;DKK
20/11/2017;kontaktløs Dankort Panum Hovedkantine;-33,32;284087,8;DKK
20/11/2017;kontaktløs Dankort Unplugged Juice To;-50;284121,12;DKK
20/11/2017;kontaktløs Dankort DET FRANSKE CONDIT;-46;284171,12;DKK
17/11/2017;kontaktløs Dankort Panum Hovedkantine;-36,27;284217,12;DKK
17/11/2017;kontaktløs Dankort Kaffebar;-200;284253,39;DKK
17/11/2017;MobilePay: Trine Nie;20;284453,39;DKK
16/11/2017;kontaktløs Dankort FREDERIKSBERG MATE;-99,95;284433,39;DKK
16/11/2017;Dankort-køb MobilePay;-235;284533,34;DKK
16/11/2017;MobilePay: Mie K. W.;20;284768,34;DKK
16/11/2017;kontaktløs Dankort Panum Hovedkantine;-40,14;284748,34;DKK
16/11/2017;MobilePay: Helle Kro;20;284788,48;DKK
16/11/2017;MobilePay: Tarun Vee;20;284768,48;DKK
16/11/2017;MobilePay: Mani Arum;20;284748,48;DKK
15/11/2017;MobilePay: Theresia;20;284728,48;DKK
15/11/2017;MobilePay: Dmitrii B;20;284708,48;DKK
15/11/2017;MobilePay: Johanne J;20;284688,48;DKK
15/11/2017;MobilePay: Torben Ha;20;284668,48;DKK
15/11/2017;kontaktløs Dankort Panum Hovedkantine;-35,5;284648,48;DKK
15/11/2017;MobilePay: Henrik Ve;20;284683,98;DKK
15/11/2017;MobilePay: Niels Gra;20;284663,98;DKK
15/11/2017;MobilePay: Annemette;20;284643,98;DKK
15/11/2017;MobilePay: Anna Katr;20;284623,98;DKK
15/11/2017;MobilePay: Alberto P;20;284603,98;DKK
15/11/2017;MobilePay: Emilie Gl;20;284583,98;DKK
15/11/2017;MobilePay: Piotr Dwo;20;284563,98;DKK
15/11/2017;MobilePay: Yuvaraj M;20;284543,98;DKK
15/11/2017;MobilePay: Tuomas Ki;20;284523,98;DKK
15/11/2017;MobilePay: Mette And;20;284503,98;DKK
15/11/2017;MobilePay: Lam Opal;20;284483,98;DKK
15/11/2017;MobilePay: Vincent A;20;284463,98;DKK
15/11/2017;MobilePay: Theresia;20;284443,98;DKK
15/11/2017;MobilePay: Line Enge;20;284423,98;DKK
14/11/2017;kontaktløs Dankort Panum Hovedkantine;-33,32;284403,98;DKK
13/11/2017;kontaktløs Dankort Panum Hovedkantine;-36,27;284437,3;DKK
13/11/2017;kontaktløs Dankort BODEGA ApS;-79;284473,57;DKK
13/11/2017;MobilePay: Lam Opal;79;284552,57;DKK
13/11/2017;kontaktløs Dankort Sweet Treat;-243;284473,57;DKK
13/11/2017;kontaktløs Dankort BODEGA ApS;-104;284716,57;DKK
13/11/2017;kontaktløs Dankort BODEGA ApS;-65;284820,57;DKK
10/11/2017;kontaktløs Dankort Panum Hovedkantine;-31,62;284885,57;DKK
09/11/2017;kontaktløs Dankort Panum Hovedkantine;-32,7;284917,19;DKK
09/11/2017;GOB SKINCARE APS, KOBENHAVN N;-280;284949,89;DKK
08/11/2017;kontaktløs Dankort Panum Hovedkantine;-35,18;285229,89;DKK
07/11/2017;kontaktløs Dankort Panum Hovedkantine;-29,92;285265,07;DKK
06/11/2017;kontaktløs Dankort Panum Hovedkantine;-35,34;285294,99;DKK
06/11/2017;OISTER.DK, KOBENHAVN;-89;285330,33;DKK
06/11/2017;Dankort-køb MobilePay;-400;285419,33;DKK
03/11/2017;Panum Hovedkantine;-40,92;285819,33;DKK
02/11/2017;kontaktløs Dankort Panum Hovedkantine;-36,89;285860,25;DKK
01/11/2017;kontaktløs Dankort Panum Hovedkantine;-29,45;285897,14;DKK
31/10/2017;kontaktløs Dankort Panum Hovedkantine;-38,44;285926,59;DKK
31/10/2017;Københavns Universit;24291,88;285965,03;DKK
31/10/2017;Account 64970001000373;-9000;261673,15;DKK
30/10/2017;kontaktløs Dankort Panum Hovedkantine;-42,16;270673,15;DKK
30/10/2017;Dankort-køb FOF KØBENHAVN;-300;270715,31;DKK
30/10/2017;kontaktløs Dankort Aldi 002;-81,65;271015,31;DKK
27/10/2017;kontaktløs Dankort Panum Hovedkantine;-32,08;271096,96;DKK
24/10/2017;kontaktløs Dankort Panum Hovedkantine;-33,48;271129,04;DKK
24/10/2017;Dankort-køb MobilePay;-20;271162,52;DKK
23/10/2017;kontaktløs Dankort Panum Hovedkantine;-44,18;271182,52;DKK
23/10/2017;MobilePay: Laure Pla;260;271226,7;DKK
20/10/2017;kontaktløs Dankort Panum Hovedkantine;-37,2;270966,7;DKK
11/10/2017;kontaktløs Dankort Panum Hovedkantine;-36,12;271003,9;DKK
10/10/2017;kontaktløs Dankort Panum Hovedkantine;-36,74;271040,02;DKK
09/10/2017;kontaktløs Dankort Panum Hovedkantine;-42,32;271076,76;DKK
09/10/2017;kontaktløs Dankort kafferiet;-90;271119,08;DKK
06/10/2017;kontaktløs Dankort Panum Hovedkantine;-37,51;271209,08;DKK
05/10/2017;OISTER.DK, KOBENHAVN;-111,98;271246,59;DKK
05/10/2017;OISTER.DK, KOBENHAVN;-89;271358,57;DKK
04/10/2017;kontaktløs Dankort Panum Hovedkantine;-25;271447,57;DKK
03/10/2017;kontaktløs Dankort Panum Hovedkantine;-36,74;271472,57;DKK
03/10/2017;Pengeautomat;-300;271509,31;DKK
02/10/2017;kontaktløs Dankort Panum Hovedkantine;-48,05;271809,31;DKK
02/10/2017;AKADEMIKERNES A-KASSE;-1302;271857,36;DKK
02/10/2017;kontaktløs Dankort Blomsterhjørnet;-65;273159,36;DKK
02/10/2017;kontaktløs Dankort Urt & Flora ApS;-40;273224,36;DKK
29/09/2017;kontaktløs Dankort Panum Hovedkantine;-39,99;273264,36;DKK
29/09/2017;Account 64970001000373;-9000;273304,35;DKK
29/09/2017;Københavns Universit;24291,88;282304,35;DKK
28/09/2017;kontaktløs Dankort Panum Hovedkantine;-40,92;258012,47;DKK
27/09/2017;Dankort-køb MobilePay;-30;258053,39;DKK
27/09/2017;kontaktløs Dankort Panum Hovedkantine;-37,04;258083,39;DKK
27/09/2017;kontaktløs Dankort August Krogh Insti;-34,34;258120,43;DKK
25/09/2017;kontaktløs Dankort Panum Hovedkantine;-41,23;258154,77;DKK
25/09/2017;Dankort-køb MobilePay;-20;258196;DKK
25/09/2017;kontaktløs Dankort Kahyt & Kaffe;-65;258216;DKK
22/09/2017;kontaktløs Dankort Panum Hovedkantine;-39,37;258281;DKK
22/09/2017;Dankort-køb MobilePay;-150;258320,37;DKK
21/09/2017;kontaktløs Dankort Panum Hovedkantine;-32,7;258470,37;DKK
20/09/2017;Dankort-køb MobilePay;-20;258503,07;DKK
20/09/2017;kontaktløs Dankort Panum Hovedkantine;-34,41;258523,07;DKK
18/09/2017;kontaktløs Dankort Panum Hovedkantine;-39,99;258557,48;DKK
18/09/2017;DSB 677 Hot RKA;-200;258597,47;DKK
18/09/2017;kontaktløs Dankort Aarstiderne A/S;-90;258797,47;DKK
18/09/2017;kontaktløs Dankort Søstrene Grene Øko;-4,96;258887,47;DKK
14/09/2017;kontaktløs Dankort August Krogh Insti;-28,73;258892,43;DKK
11/09/2017;kontaktløs Dankort SILVAN 647 Nørrebr;-117,54;258921,16;DKK
11/09/2017;kontaktløs Dankort DET FRANSKE CONDIT;-35;259038,7;DKK
08/09/2017;kontaktløs Dankort August Krogh Insti;-38,42;259073,7;DKK
05/09/2017;OISTER.DK, KOBENHAVN;-86;259112,12;DKK
04/09/2017;kontaktløs Dankort Jarsbo Is;-33;259198,12;DKK
04/09/2017;MobilePay: Maria Cam;160;259231,12;DKK
04/09/2017;kontaktløs Dankort Kajakhotellet;-1639;259071,12;DKK
04/09/2017;kontaktløs Dankort Rema 1000;-73,55;260710,12;DKK
04/09/2017;Cafe A;-96;260783,67;DKK
04/09/2017;MobilePay: Asker Bre;160;260879,67;DKK
04/09/2017;MobilePay: Lam Opal;160;260719,67;DKK
04/09/2017;MobilePay: Yuvaraj M;160;260559,67;DKK
31/08/2017;Udland - 1/PAPINSKI DANIEL;1020;260399,67;DKK
31/08/2017;Account 64970001000373;-9000;259379,67;DKK
31/08/2017;Københavns Universit;26310,88;268379,67;DKK
30/08/2017;kontaktløs Dankort Rema 1000;-35,5;242068,79;DKK
29/08/2017;kontaktløs Dankort Nørrebro Apotek v/;-77,6;242104,29;DKK
29/08/2017;kontaktløs Dankort Rema 1000;-59,8;242181,89;DKK
29/08/2017;Dankort-køb MobilePay;-20;242241,69;DKK
29/08/2017;MILKSHAKEN COPENHAGEN ST, KOEBENHA;-22;242261,69;DKK
29/08/2017;kontaktløs Dankort August Krogh Insti;-25,5;242283,69;DKK
28/08/2017;kontaktløs Dankort Rema 1000;-60,25;242309,19;DKK
28/08/2017;kontaktløs Dankort Aldi 002;-98,15;242369,44;DKK
28/08/2017;kontaktløs Dankort LA TIENDA;-105;242467,59;DKK
28/08/2017;kontaktløs Dankort Byman Sport;-1000;242572,59;DKK
28/08/2017;kontaktløs Dankort Rema 1000;-26,95;243572,59;DKK
21/08/2017;Dankort-køb MobilePay;-20;243599,54;DKK
21/08/2017;kontaktløs Dankort Kajakhotellet;-60;243619,54;DKK
21/08/2017;Dankort-køb kajakbasen.dk;-390;243679,54;DKK
16/08/2017;Dankort-køb MobilePay;-20;244069,54;DKK
14/08/2017;Give Stenovns Pizz;-185;244089,54;DKK
14/08/2017;Dankort-køb MobilePay;-1100;244274,54;DKK
14/08/2017;Det Gamle Røgeri;-235;245374,54;DKK
09/08/2017;kontaktløs Dankort August Krogh Insti;-33,15;245609,54;DKK
08/08/2017;Dankort-køb MobilePay;-20;245642,69;DKK
07/08/2017;Dankort-køb MobilePay;-20;245662,69;DKK
07/08/2017;Dankort-køb MobilePay;-400;245682,69;DKK
07/08/2017;kontaktløs Dankort August Krogh Insti;-37,74;246082,69;DKK
04/08/2017;OISTER.DK, KOBENHAVN;-86;246120,43;DKK
01/08/2017;Pengeautomat;-300;246206,43;DKK
31/07/2017;Account 64970001000373;-9000;246506,43;DKK
31/07/2017;Københavns Universit;26310,88;255506,43;DKK
26/07/2017;DSB 646 Kn RKA;-200;229195,55;DKK
24/07/2017;MobilePay: Nick Jens;91;229395,55;DKK
24/07/2017;Dankort-køb MobilePay;-204;229304,55;DKK
19/07/2017;Pengeautomat;-300;229508,55;DKK
17/07/2017;Lisehusets Iscafé;-69;229808,55;DKK
17/07/2017;kontaktløs Dankort Aldi 045;-25,9;229877,55;DKK
14/07/2017;kontaktløs Dankort DET FRANSKE CONDIT;-151;229903,45;DKK
13/07/2017;kontaktløs Dankort Aldi 002;-146,65;230054,45;DKK
11/07/2017;IZ *SOCIAL APS, KOBENHAVN N;-109;230201,1;DKK
11/07/2017;IZ *SOCIAL APS, KOBENHAVN N;-58;230310,1;DKK
10/07/2017;Manfreds Take Away;-920;230368,1;DKK
06/07/2017;kontaktløs Dankort Symbion A/S;-48,38;231288,1;DKK
04/07/2017;OISTER.DK, KOBENHAVN;-86;231336,48;DKK
03/07/2017;kontaktløs Dankort California Kitchen;-240;231422,48;DKK
03/07/2017;kontaktløs Dankort California Kitchen;-40;231662,48;DKK
03/07/2017;AKADEMIKERNES A-KASSE;-1302;231702,48;DKK
03/07/2017;DSB 703 Van RKA;-200;233004,48;DKK
30/06/2017;Account 64970001000373;-9000;233204,48;DKK
30/06/2017;Københavns Universit;26310,88;242204,48;DKK
30/06/2017;kontaktløs Dankort Kalaset ApS;-80;215893,6;DKK
30/06/2017;kontaktløs Dankort Pub & Sport;-110;215973,6;DKK
29/06/2017;kontaktløs Dankort August Krogh Insti;-37,57;216083,6;DKK
27/06/2017;kontaktløs Dankort Symbion A/S;-53,44;216121,17;DKK
27/06/2017;Symbion A/S;-50;216174,61;DKK
26/06/2017;kontaktløs Dankort Parterre;-60;216224,61;DKK
23/06/2017;kontaktløs Dankort BeerDuck ApS;-60;216284,61;DKK
20/06/2017;kontaktløs Dankort August Krogh Insti;-32,98;216344,61;DKK
16/06/2017;Dankort Astrups Imperium v;-270;216377,59;DKK
15/06/2017;kontaktløs Dankort Kaf;-97;216647,59;DKK
14/06/2017;kontaktløs Dankort The Coffee Collect;-100;216744,59;DKK
13/06/2017;Pengeautomat;-300;216844,59;DKK
12/06/2017;kontaktløs Dankort Kaffeplantagen ApS;-70;217144,59;DKK
07/06/2017;OISTER.DK, KOBENHAVN;-86;217214,59;DKK
06/06/2017;kontaktløs Dankort Kaf;-127;217300,59;DKK
01/06/2017;PAUSERIET, FREDERIKSBERG;-60;217427,59;DKK
31/05/2017;Account 64970001000373;-9000;217487,59;DKK
31/05/2017;Københavns Universit;26310,88;226487,59;DKK
30/05/2017;IZ *MARRAKECH STRE, KOBENHAVN NV;-80;200176,71;DKK
29/05/2017;Dankort Studenterhuset;-32;200256,71;DKK
24/05/2017;Dankort Mahalle;-130;200288,71;DKK
22/05/2017;Dankort Studenterhuset;-25;200418,71;DKK
22/05/2017;kontaktløs Dankort SØREN K;-30;200443,71;DKK
19/05/2017;kontaktløs Dankort BeerDuck ApS;-65;200473,71;DKK
18/05/2017;Dankort August Krogh Insti;-29,07;200538,71;DKK
17/05/2017;HANS HJULMAND TAND;-2248,52;200567,78;DKK
15/05/2017;kontaktløs Dankort SILVAN;-59,85;202816,3;DKK
11/05/2017;DSB 681 Li RKA;-200;202876,15;DKK
08/05/2017;kontaktløs Dankort Kalaset ApS;-90;203076,15;DKK
08/05/2017;kontaktløs Dankort SILVAN;-39,95;203166,15;DKK
08/05/2017;Bellahøj Svømmesta;-360;203206,1;DKK
08/05/2017;kontaktløs Dankort SØREN K;-30;203566,1;DKK
08/05/2017;Sundsult Aps;-59;203596,1;DKK
04/05/2017;OISTER.DK, KOBENHAVN;-86;203655,1;DKK
02/05/2017;Pengeautomat;-300;203741,1;DKK
01/05/2017;kontaktløs Dankort DET FRANSKE CONDIT;-35;204041,1;DKK
01/05/2017;Kaffe Biksen;-113;204076,1;DKK
01/05/2017;Mikkeller & Friend;-35;204189,1;DKK
01/05/2017;kontaktløs Dankort Mikkeller & Friend;-35;204224,1;DKK
01/05/2017;kontaktløs Dankort Mikkeller & Friend;-75;204259,1;DKK
28/04/2017;Account 64970001000373;-9000;204334,1;DKK
28/04/2017;Københavns Universit;29918,42;213334,1;DKK
24/04/2017;Restaurant Kreta;-219;183415,68;DKK
20/04/2017;kontaktløs Dankort DEN GLADE GRIS ApS;-35;183634,68;DKK
20/04/2017;Dankort-køb MobilePay;-20;183669,68;DKK
18/04/2017;kontaktløs Dankort Magasin, Kgs Nytor;-118;183689,68;DKK
11/04/2017;SHABAZ PANUM, KOEBENHAVN N;-164;183807,68;DKK
11/04/2017;OVERSKYDENDE SKAT;11406;183971,68;DKK
10/04/2017;kontaktløs Dankort Bello e Buono;-205;172565,68;DKK
10/04/2017;FK-Feriepenge;865,75;172770,68;DKK
04/04/2017;Pengeautomat;-500;171904,93;DKK
03/04/2017;AKADEMIKERNES A-KASSE;-1302;172404,93;DKK
03/04/2017;Dankort-køb Oister;-86;173706,93;DKK
31/03/2017;Account 64970001000373;-9000;173792,93;DKK
31/03/2017;Københavns Universit;23795,61;182792,93;DKK
27/03/2017;Dankort-køb Oister;-110,01;158997,32;DKK
20/03/2017;Dankort Social Food Freder;-300;159107,33;DKK
16/03/2017;kontaktløs Dankort CPHLIVING;-149;159407,33;DKK
16/03/2017;kontaktløs Dankort Søstrene Grene Øko;-9,18;159556,33;DKK
16/03/2017;kontaktløs Dankort LEGO store DK;-40;159565,51;DKK
13/03/2017;Dankort PANDURO HOBBY;-39;159605,51;DKK
13/03/2017;Dankort-køb MobilePay;-20;159644,51;DKK
09/03/2017;Dankort Guld & Grønneskove;-4700;159664,51;DKK
08/03/2017;Dankort-køb MobilePay;-20;164364,51;DKK
06/03/2017;kontaktløs Dankort SØREN K;-235;164384,51;DKK
06/03/2017;kontaktløs Dankort DET FRANSKE CONDIT;-65;164619,51;DKK
06/03/2017;Dankort-køb MobilePay;-144;164684,51;DKK
03/03/2017;kontaktløs Dankort BeerDuck ApS;-90;164828,51;DKK
03/03/2017;kontaktløs Dankort DET FRANSKE CONDIT;-152;164918,51;DKK
03/03/2017;Ehlers-Danlos for;-100;165070,51;DKK
03/03/2017;Dankort-køb Oister;-86;165170,51;DKK
03/03/2017;MobilePay: Alireza;25;165256,51;DKK
02/03/2017;Dankort Guld & Grønneskove;-1000;165231,51;DKK
28/02/2017;Account 64970001000373;-9000;166231,51;DKK
28/02/2017;Københavns Universit;26017,85;175231,51;DKK
27/02/2017;MobilePay: Piotr Dwo;66;149213,66;DKK
23/02/2017;kontaktløs Dankort August Krogh Insti;-60,95;149147,66;DKK
21/02/2017;Pengeautomat;-300;149208,61;DKK
20/02/2017;)))) MobilePay Notanr 1636937427;-240;149508,61;DKK
20/02/2017;)))) MobilePay Notanr 1636655691;-96;149748,61;DKK
14/02/2017;FRILUFTSLAND A/S;-499;149844,61;DKK
14/02/2017;Visa/Dankort KontantGebyr Nota nr.;-30;150343,61;DKK
14/02/2017;Visa/Dankort NOK  1047,97 Kurs 84,638 Nota nr. 40961 REMA 1000 ELGEN, ELVERUM;-886,99;150373,61;DKK
14/02/2017;Visa/Dankort NOK   800,00 Kurs 84,638 Nota nr. 69253 ATM DNB OSLO KARL JOHANSG, OSLO;-677,11;151260,6;DKK
14/02/2017;Visa/Dankort NOK   125,00 Kurs 84,640 Nota nr. 39709 IZ *EVENSTUEN CONS, RENDALEN;-105,8;151937,71;DKK
14/02/2017;Visa/Dankort NOK    93,00 Kurs 84,634 Nota nr. 06968 NSB OSL TVM, GARDERMOEN;-78,71;152043,51;DKK
14/02/2017;DSB 858 Cph RKA;-200;152122,22;DKK
14/02/2017;kontaktløs Dankort Rema 1000;-113,85;152322,22;DKK
13/02/2017;MobilePay: Pascal Ti;75;152436,07;DKK
08/02/2017;kontaktløs Dankort Spejder Sport A/S;-39;152361,07;DKK
03/02/2017;Dankort-køb Oister;-86;152400,07;DKK
02/02/2017;Dankort-køb MobilePay;-64;152486,07;DKK
01/02/2017;AKADEMIKERNES A-KASSE;-1494,84;152550,07;DKK
31/01/2017;Account 64970001000373;-9000;154044,91;DKK
31/01/2017;Københavns Universit;26017,85;163044,91;DKK
30/01/2017;kontaktløs Dankort Pølse Kompagniet A;-98;137027,06;DKK
30/01/2017;kontaktløs Dankort 7-Eleven B 022;-60;137125,06;DKK
26/01/2017;kontaktløs Dankort VEGA - MUSIKKENS H;-140;137185,06;DKK
24/01/2017;kontaktløs Dankort kafferiet;-160;137325,06;DKK
24/01/2017;Pengeautomat;-200;137485,06;DKK
23/01/2017;Kates Joint ApS;-142;137685,06;DKK
13/01/2017;Dankort-køb musikundervisning. Nota 81.258.233;-1120;137827,06;DKK
10/01/2017;Pengeautomat;-300;138947,06;DKK
09/01/2017;kontaktløs Dankort The American Pie C;-110;139247,06;DKK
05/01/2017;Dankort-køb Oister;-86;139357,06;DKK
03/01/2017;Pengeautomat;-500;139443,06;DKK
02/01/2017;Den Franske Bogcaf;-92;139943,06;DKK
31/12/2016;Rente af indestående;109,15;140035,06;DKK
30/12/2016;Account 64970001000373;-9000;139925,91;DKK
30/12/2016;Københavns Universit;26604,85;148925,91;DKK
23/12/2016;Kalaset ApS;-115;122321,06;DKK
22/12/2016;Øbro Hallen;-360;122436,06;DKK
22/12/2016;Dankort-køb Billetten A/S Nota 64-24189-83;-501,74;122796,06;DKK
19/12/2016;Restaurant La Peta;-538;123297,8;DKK
19/12/2016;MobilePay: Alberto P;250;123835,8;DKK
15/12/2016;kontaktløs Dankort Symbion A/S;-25,88;123585,8;DKK
13/12/2016;IZ *TAK FOR KAFFE, KOBENHAVN K;-90;123611,68;DKK
12/12/2016;kontaktløs Dankort Zoologisk Have i K;-242,9;123701,68;DKK
12/12/2016;kontaktløs Dankort DET FRANSKE CONDIT;-47;123944,58;DKK
12/12/2016;kontaktløs Dankort LEGO store DK;-180;123991,58;DKK
09/12/2016;Dankort-køb MobilePay;-20;124171,58;DKK
09/12/2016;Dankort-køb MobilePay;-150;124191,58;DKK
07/12/2016;DSB 675 Ly RKA;-200;124341,58;DKK
07/12/2016;kontaktløs Dankort Burger King;-46;124541,58;DKK
07/12/2016;IZ *TAK FOR KAFFE, KOBENHAVN K;-105;124587,58;DKK
05/12/2016;kontaktløs Dankort Matas 14200;-39,95;124692,58;DKK
05/12/2016;Big Apple;-25;124732,53;DKK
05/12/2016;Dankort-køb Nordisk Film Bio;-111,39;124757,53;DKK
05/12/2016;Dankort-køb Oister;-86;124868,92;DKK
05/12/2016;kontaktløs Dankort Imperial;-40;124954,92;DKK
30/11/2016;Account 64970001000373;-9000;124994,92;DKK
30/11/2016;Københavns Universit;26604,85;133994,92;DKK
29/11/2016;MobilePay: Ehm;20;107390,07;DKK
29/11/2016;kontaktløs Dankort Gløggkompagniet;-80;107370,07;DKK
28/11/2016;MobilePay: Christian;20;107450,07;DKK
28/11/2016;MobilePay: Trine Nie;20;107430,07;DKK
28/11/2016;Magasin, Kgs Nytor;-260;107410,07;DKK
28/11/2016;AFRICAN TOUCH ApS;-75;107670,07;DKK
28/11/2016;kontaktløs Dankort CRAFT Coffeeshop;-85;107745,07;DKK
28/11/2016;Cafe Rosa;-30;107830,07;DKK
28/11/2016;FARAOS CIGARER;-359,2;107860,07;DKK
25/11/2016;MobilePay: Trine Fri;20;108219,27;DKK
24/11/2016;MobilePay: Timo Seba;20;108199,27;DKK
24/11/2016;MobilePay: Niels Gra;20;108179,27;DKK
24/11/2016;MobilePay: Annemette;20;108159,27;DKK
24/11/2016;MobilePay: Line Enge;20;108139,27;DKK
24/11/2016;Dankort-køb MobilePay;-200;108119,27;DKK
24/11/2016;MobilePay: Torben Ha;20;108319,27;DKK
23/11/2016;MobilePay: Jette Bor;20;108299,27;DKK
23/11/2016;MobilePay: Maria Cam;20;108279,27;DKK
23/11/2016;MobilePay: Tuomas Ki;20;108259,27;DKK
23/11/2016;MobilePay: Henrik Ve;20;108239,27;DKK
23/11/2016;MobilePay: Mette And;20;108219,27;DKK
23/11/2016;MobilePay: Alberto P;20;108199,27;DKK
23/11/2016;MobilePay: Vincent A;20;108179,27;DKK
23/11/2016;Dankort-køb MobilePay;-20;108159,27;DKK
23/11/2016;MobilePay: Yuvaraj M;20;108179,27;DKK
23/11/2016;MobilePay: Mani Arum;20;108159,27;DKK
23/11/2016;Dankort-køb KKB;-345;108139,27;DKK
11/11/2016;Visa/Dankort;-784;108484,27;DKK
10/11/2016;Ekspeditionsgebyr;-200;109268,27;DKK
08/11/2016;IZ *GULD OG URT, KOBENHAVN N;-1500;109468,27;DKK
04/11/2016;Baresso Coffee A/S;-103;110968,27;DKK
04/11/2016;DET FRANSKE CONDIT;-123;111071,27;DKK
03/11/2016;Dankort-køb Oister;-86;111194,27;DKK
01/11/2016;Vaffelbager.Tivoli;-130;111280,27;DKK
31/10/2016;Account 64970001000373;-9000;111410,27;DKK
31/10/2016;VON FRESSEN ApS;-125;120410,27;DKK
31/10/2016;Københavns Universit;26604,85;120535,27;DKK
31/10/2016;Dankort-køb MobilePay;-65;93930,42;DKK
20/10/2016;Symbion A/S;-56,81;93995,42;DKK
18/10/2016;Pengeautomat;-300;94052,23;DKK
17/10/2016;Dankort-køb MobilePay;-230;94352,23;DKK
13/10/2016;Øbro Hallen;-360;94582,23;DKK
12/10/2016;Amazon UK Marketplace, 800-279-6620 GBP 95,00;-796,79;94942,23;DKK
10/10/2016;Dankort-køb MobilePay;-20;95739,02;DKK
03/10/2016;Dankort-køb Oister;-86;95759,02;DKK
30/09/2016;Account 64970001000373;-9000;95845,02;DKK
30/09/2016;Københavns Universit;26604,85;104845,02;DKK
29/09/2016;BB blomster ApS;-68;78240,17;DKK
29/09/2016;Pengeautomat;-300;78308,17;DKK
26/09/2016;Cafe Munk;-610;78608,17;DKK
12/09/2016;Café La Esquina Ap;-58;79218,17;DKK
12/09/2016;Dankort-køb MobilePay;-170;79276,17;DKK
12/09/2016;Dankort-køb MobilePay;-170;79446,17;DKK
06/09/2016;IZ *MONELLIES, FREDERIKSBERG;-105;79616,17;DKK
05/09/2016;Dankort-køb Oister;-86;79721,17;DKK
05/09/2016;M Forum RVM;-200;79807,17;DKK
05/09/2016;REINH VAN HAUEN;-86;80007,17;DKK
31/08/2016;Account 64970001000373;-9000;80093,17;DKK
31/08/2016;Københavns Universit;26604,85;89093,17;DKK
30/08/2016;IZ *GAO DUMPLING B, COPENHAGEN N;-310;62488,32;DKK
29/08/2016;Dankort Bryggen 21 ApS;-86;62798,32;DKK
29/08/2016;Tante T Torvehalle;-253;62884,32;DKK
26/08/2016;Hos Buller v/Poul;-330;63137,32;DKK
24/08/2016;Netto Frederiksber;-73,65;63467,32;DKK
22/08/2016;Dankort-køb www.sparshipping.d;-670;63540,97;DKK
16/08/2016;Designcafeen I/S;-55;64210,97;DKK
15/08/2016;The Coffee Collect;-50;64265,97;DKK
12/08/2016;Pengeautomat;-300;64315,97;DKK
12/08/2016;Generator Hostel C;-40;64615,97;DKK
05/08/2016;Café La Esquina Ap;-67;64655,97;DKK
01/08/2016;Visa/Dankort SEK  1110,00 Kurs 78,893 Nota nr. 36692 TUNA KROG, SANKT IBB;-875,72;64722,97;DKK
01/08/2016;Visa/Dankort SEK   293,00 Kurs 78,894 Nota nr. 98791 HAMNKROGENSNEPPET BET, VIKEN;-231,16;65598,69;DKK
01/08/2016;Visa/Dankort SEK   200,00 Kurs 78,895 Nota nr. 63718 NORREBORGS HAMN VEN, SANKT IBB;-157,79;65829,85;DKK
01/08/2016;Visa/Dankort SEK   140,00 Kurs 78,892 Nota nr. 18316 IZ *HALSA FRAN HVE, SANKT IBB;-110,45;65987,64;DKK
01/08/2016;Visa/Dankort SEK    85,00 Kurs 78,894 Nota nr. 09178 IZ *VEN TUNA KROG, SANKT IBB;-67,06;66098,09;DKK
01/08/2016;Dankort Shabaz Bülowsvej;-93;66165,15;DKK
29/07/2016;Taxa 4 X 35;-155;66258,15;DKK
29/07/2016;Account 64970001000373;-9000;66413,15;DKK
29/07/2016;Københavns Universit;26604,85;75413,15;DKK
28/07/2016;Visa/Dankort SEK    92,00 Kurs 79,195 Nota nr. 18359 SKANETRAFIKEN 01, HASSLEHOLM;-72,86;48808,3;DKK
28/07/2016;Visa/Dankort SEK    92,00 Kurs 79,195 Nota nr. 05905 SKANETRAFIKEN 13, HASSLEHOLM;-72,86;48881,16;DKK
27/07/2016;Visa/Dankort SEK  1260,00 Kurs 79,184 Nota nr. 57654 FIRST CAMP MOLL, MOLLE;-997,73;48954,02;DKK
27/07/2016;Visa/Dankort SEK    68,00 Kurs 79,176 Nota nr. 09040 SKANETRAFIKEN 01, HASSLEHOLM;-53,84;49951,75;DKK
26/07/2016;Visa/Dankort SEK  1000,00 Kurs 79,406 Nota nr. 28030 BANKOMAT STORGATAN 60, HOGANAS;-794,06;50005,59;DKK
26/07/2016;Visa/Dankort SEK   180,00 Kurs 79,411 Nota nr. 53673 HOGANAS BAATSALLSKAP, HOGANAS;-142,94;50799,65;DKK
25/07/2016;Kontantgebyr, STORGATAN 60 HOGANAS;-30;50942,59;DKK
20/07/2016;Spejder Sport A/S;-838;50972,59;DKK
20/07/2016;Games/Karrusella;-179;51810,59;DKK
19/07/2016;Foodie I/S;-158;51989,59;DKK
18/07/2016;HOOHA;-350;52147,59;DKK
18/07/2016;GREENSUSHI ApS;-233;52497,59;DKK
18/07/2016;HOOHA;-150;52730,59;DKK
14/07/2016;Symbion A/S;-34,88;52880,59;DKK
13/07/2016;FRILUFTSLAND A/S;499;52915,47;DKK
12/07/2016;Visa/Dankort SEK   272,11 Kurs 79,464 Nota nr. 50563 EKO FJALKINGE, FJALKINGE;-216,23;52416,47;DKK
12/07/2016;Visa/Dankort SEK   120,00 Kurs 79,466 Nota nr. 81765 OLOFSTROMS FRITIDSKLUB, OLOFSTROM;-95,36;52632,7;DKK
12/07/2016;Visa/Dankort SEK   105,00 Kurs 79,466 Nota nr. 40820 APOTEK HJARTAT MALMO JAGE, MALMO;-83,44;52728,06;DKK
05/07/2016;Pengeautomat;-300;52811,5;DKK
04/07/2016;Visa/Dankort SEK   660,00 Kurs 79,919 Nota nr. 30259 WWW.NORDICTRAVEL.SE, YSTAD;-527,47;53111,5;DKK
04/07/2016;Dankort-køb Oister;-177;53638,97;DKK
04/07/2016;Nha Trang v/Thang;-621;53815,97;DKK
04/07/2016;FREDERIKSBERG MATE;-72,95;54436,97;DKK
04/07/2016;FRILUFTSLAND A/S;-499;54509,92;DKK
04/07/2016;JOE & THE JUICE Øs;-188;55008,92;DKK
01/07/2016;KAYAK REPUBLIC, 4522884989;-4550;55196,92;DKK
01/07/2016;Overførsel;560;59746,92;DKK
30/06/2016;Account 64970001000373;-9000;59186,92;DKK
30/06/2016;Københavns Universit;26604,85;68186,92;DKK
28/06/2016;IZ *SING TEHUS APS, KOBENHAVN K;-155;41582,07;DKK
20/06/2016;Dankort Vinhanen S.M.B.A;-55;41737,07;DKK
20/06/2016;Dankort-køb MobilePay;-90;41792,07;DKK
20/06/2016;LA TIENDA;-50;41882,07;DKK
20/06/2016;DET FRANSKE CONDIT;-48;41932,07;DKK
20/06/2016;M Kgs. Nytorv RVM;-200;41980,07;DKK
20/06/2016;VAFFELBAGEREN I/S;-35;42180,07;DKK
20/06/2016;Palæo;-232;42215,07;DKK
17/06/2016;LUFTHANSA AG2202369743943, KOELN;-1382;42447,07;DKK
15/06/2016;Rema 1000;-87,45;43829,07;DKK
15/06/2016;Dankort August Krogh Insti;-38,13;43916,52;DKK
14/06/2016;Straksoverførsel gennemført  pr. 14-06-2016/Konto 32640016176850;-100;43954,65;DKK
13/06/2016;Tivoli A/S F&B;-140;44054,65;DKK
13/06/2016;Zoologisk Have i K;-69;44194,65;DKK
13/06/2016;Dankort-køb MobilePay;-75;44263,65;DKK
07/06/2016;Visa/Dankort SEK   119,90 Kurs 81,259 Nota nr. 38869 COOP KONSUM MORRUM, MORRUM;-97,43;44338,65;DKK
07/06/2016;Visa/Dankort SEK    44,00 Kurs 81,250 Nota nr. 51569 MATVIK - TARNOLINJEN, KARLSHAMN;-35,75;44436,08;DKK
07/06/2016;Dankort August Krogh Insti;-44,08;44471,83;DKK
03/06/2016;DET FRANSKE CONDIT;-51;44515,91;DKK
02/06/2016;Dankort August Krogh Insti;-39,4;44566,91;DKK
01/06/2016;Pengeautomat;-300;44606,31;DKK
31/05/2016;Københavns Universit;26604,85;44906,31;DKK
31/05/2016;Account 64970001000373;-9000;18301,46;DKK
30/05/2016;coffee 24 v/ Aform;-50;27301,46;DKK
27/05/2016;Øbro Hallen;-360;27351,46;DKK
26/05/2016;LØGISMOSE A/S;-65;27711,46;DKK
23/05/2016;Dankort The American Pie C;-145;27776,46;DKK
23/05/2016;FRILUFTSLAND A/S;-79;27921,46;DKK
17/05/2016;Cleaver's Meat Mar;-64;28000,46;DKK
17/05/2016;Risteriet Aps;-100;28064,46;DKK
12/05/2016;Paradis Trianglen;-74;28164,46;DKK
11/05/2016;FREDERIKSBERG MATE;-54,95;28238,46;DKK
11/05/2016;Pengeautomat;-300;28293,41;DKK
10/05/2016;OVERFOR CAFÉ & BAR;-73;28593,41;DKK
10/05/2016;Rema 1000;-68,25;28666,41;DKK
10/05/2016;M Forum TVM;-36;28734,66;DKK
10/05/2016;SILVAN;-169,95;28770,66;DKK
10/05/2016;Foodie I/S;-100;28940,61;DKK
10/05/2016;Dankort-køb MobilePay;-100;29040,61;DKK
10/05/2016;Rema 1000;-50,4;29140,61;DKK
09/05/2016;Netto-Bådene;-80;29191,01;DKK
09/05/2016;Dankort-køb MobilePay;-155;29271,01;DKK
09/05/2016;cafe Tænk;-106;29426,01;DKK
09/05/2016;Rema 1000;-62,5;29532,01;DKK
09/05/2016;Strandkiosken;-56;29594,51;DKK
09/05/2016;M Forum RVM;-200;29650,51;DKK
09/05/2016;Stefanos Delikates;-40;29850,51;DKK
09/05/2016;Dankort-køb Oister;-118,73;29890,51;DKK
09/05/2016;Taxa 4 X 35;-136;30009,24;DKK
09/05/2016;Rema 1000;-126,65;30145,24;DKK
09/05/2016;The Coffee Collect;-66;30271,89;DKK
04/05/2016;Rema 1000;-85,35;30337,89;DKK
04/05/2016;The Dubliner Downt;-62;30423,24;DKK
03/05/2016;KaffeVærket;-65;30485,24;DKK
02/05/2016;Rema 1000;-80,45;30550,24;DKK
02/05/2016;Østerbros Original;-169;30630,69;DKK
29/04/2016;DET FRANSKE CONDIT;-152;30799,69;DKK
29/04/2016;Københavns Universit;26604,85;30951,69;DKK
29/04/2016;Account 64970001000373;-9000;4346,84;DKK
28/04/2016;Rema 1000;-110,8;13346,84;DKK
28/04/2016;Aldi 002;-113,25;13457,64;DKK
26/04/2016;Rema 1000;-140,4;13570,89;DKK
26/04/2016;Pengeautomat;-300;13711,29;DKK
25/04/2016;Rema 1000;-102,3;14011,29;DKK
25/04/2016;LOUISIANA FONDEN;-105;14113,59;DKK
25/04/2016;LOUISIANA FONDEN;-230;14218,59;DKK
25/04/2016;Dankort Studenterhuset;-50;14448,59;DKK
25/04/2016;Rema 1000;-59,35;14498,59;DKK
25/04/2016;Rema 1000;-109,1;14557,94;DKK
25/04/2016;SØREN K;-129;14667,04;DKK
21/04/2016;HANS HJULMAND TAND;-1260;14796,04;DKK
18/04/2016;REINH VAN HAUEN;-64;16056,04;DKK
18/04/2016;Dankort-køb MobilePay;-105;16120,04;DKK
15/04/2016;Dankort Summerbird Chocola;-152;16225,04;DKK
15/04/2016;Sundsult Aps;-74;16377,04;DKK
12/04/2016;Pengeautomat;-300;16451,04;DKK
11/04/2016;DSB Øresund 669 Hg;-200;16751,04;DKK
11/04/2016;Noma;-760;16951,04;DKK
08/04/2016;Dankort-køb MobilePay;-160;17711,04;DKK
07/04/2016;HANS HJULMAND TAND;-700,55;17871,04;DKK
07/04/2016;Dankort August Krogh Insti;-47,6;18571,59;DKK
04/04/2016;Pasta Plus ApS;-94;18619,19;DKK
04/04/2016;Dankort-køb Oister;-159,39;18713,19;DKK
04/04/2016;WaterWear;-490;18872,58;DKK
04/04/2016;Chilimili;-158;19362,58;DKK
31/03/2016;Københavns Universit;16496,86;19520,58;DKK
31/03/2016;Account 64970001000373;-9000;3023,72;DKK
30/03/2016;Pengeautomat;-300;12023,72;DKK
29/03/2016;ADAMSEN`S FISK APS;-181;12323,72;DKK
29/03/2016;DSB 617 Ro RKA;-200;12504,72;DKK
29/03/2016;ParadIS Roskilde A;-65;12704,72;DKK
29/03/2016;Imerco Frederiksbe;-199,95;12769,72;DKK
29/03/2016;PAPYRUS BOGCAFE Ap;-124;12969,67;DKK
29/03/2016;Øbro Hallen;-40;13093,67;DKK
29/03/2016;Parterre;-205;13133,67;DKK
29/03/2016;Pengeautomat;-300;13338,67;DKK
29/03/2016;Lønoverførsel;32,51;13638,67;DKK
17/03/2016;Cravings ApS;-85;13606,16;DKK
17/03/2016;Dankort SKAAL;-30;13691,16;DKK
15/03/2016;Pussy G. F. Cirkus;-70;13721,16;DKK
14/03/2016;World Of Flowers v;-45;13791,16;DKK
14/03/2016;AFRICAN TOUCH ApS;-475;13836,16;DKK
07/03/2016;Tribeca.Nv;-257;14311,16;DKK
07/03/2016;Tips & Lotto;-42;14568,16;DKK
04/03/2016;Aldi 008;-44,9;14610,16;DKK
03/03/2016;Øbro Hallen;-360;14655,06;DKK
03/03/2016;Games/Karrusella;-199;15015,06;DKK
29/02/2016;Account 64970001000373;-9000;15214,06;DKK
25/02/2016;Mokkariet;-62;24214,06;DKK
25/02/2016;Lønoverførsel;261,52;24276,06;DKK
25/02/2016;Kalaset ApS;-130;24014,54;DKK
25/02/2016;Kalaset ApS;-105;24144,54;DKK
24/02/2016;Pub & Sport;-97;24249,54;DKK
23/02/2016;Overførsel fra udland - omkostninger;-20;24346,54;DKK
23/02/2016;Overførsel fra udland;7448,8;24366,54;DKK
19/02/2016;Democratic Coffee;-85;16917,74;DKK
16/02/2016;Overførsel fra udland - omkostninger;-20;17002,74;DKK
16/02/2016;Overførsel fra udland;7451,4;17022,74;DKK
15/02/2016;Paradis Frugt Colo;-45;9571,34;DKK
15/02/2016;DET FRANSKE CONDIT;-44,5;9616,34;DKK
15/02/2016;Straksoverførsel gennemført  pr. 14-02-2016/Konto 63010007425821;-675;9660,84;DKK
15/02/2016;Dankort-køb Billetten A/S Nota 64-19317-83;-501,74;10335,84;DKK
12/02/2016;FREDERIKSBERG MATE;-49,95;10837,58;DKK
08/02/2016;JOE & THE JUICE Øs;-190;10887,53;DKK
08/02/2016;M Forum RVM;-200;11077,53;DKK
03/02/2016;Original Coffee;-67;11277,53;DKK
03/02/2016;Dankort-køb Oister;-159,39;11344,53;DKK
01/02/2016;A. BUSCK, KBH;-169,95;11503,92;DKK
01/02/2016;Amokka Butik;-53;11673,87;DKK
01/02/2016;Pengeautomat;-300;11726,87;DKK
29/01/2016;DET FRANSKE CONDIT;-130;12026,87;DKK
29/01/2016;Account 64970001000373;-9000;12156,87;DKK
28/01/2016;Vinbørsen;-148;21156,87;DKK
27/01/2016;Lønoverførsel;6755,84;21304,87;DKK
26/01/2016;YOBURGER;-132;14549,03;DKK
25/01/2016;HV GRUPPEN ApS;-64;14681,03;DKK
25/01/2016;Copenhagen Paintb;-200;14745,03;DKK
25/01/2016;JOE & THE JUICE Øs;-190;14945,03;DKK
25/01/2016;Original Coffee;-67;15135,03;DKK
21/01/2016;JOE & THE JUICE Øs;-134;15202,03;DKK
19/01/2016;Overførsel fra udland - omkostninger;-20;15336,03;DKK
19/01/2016;Overførsel fra udland;7449,8;15356,03;DKK
18/01/2016;JOE & THE JUICE Øs;-138;7906,23;DKK
18/01/2016;Havgården Badehote;-2170;8044,23;DKK
12/01/2016;Pengeautomat;-400;10214,23;DKK
11/01/2016;Original Coffee;-62;10614,23;DKK
11/01/2016;Straksoverførsel gennemført  pr. 10-01-2016/Buffer faelles;-4000;10676,23;DKK
08/01/2016;Poppi Dyrecenter;-89;14676,23;DKK
05/01/2016;Pengeautomat;-500;14765,23;DKK
05/01/2016;Original Coffee;-99;15265,23;DKK
04/01/2016;Ipsen og co.;-75;15364,23;DKK
04/01/2016;BAGEREN I NANSENSG;-55;15439,23;DKK
04/01/2016;Dankort Madklubben;-515;15494,23;DKK
04/01/2016;Dankort Madklubben;-50;16009,23;DKK
04/01/2016;REINH VAN HAUEN;-109;16059,23;DKK
04/01/2016;BOGhandleren Frb.;-59,9;16168,23;DKK
04/01/2016;Rema 1000;-125,6;16228,13;DKK
31/12/2015;Rente af indestående;60,73;16353,73;DKK
29/12/2015;Aldi 002;-112,85;16293;DKK
28/12/2015;The Coffee Factory;-84;16405,85;DKK
28/12/2015;Rema 1000;-90,05;16489,85;DKK
18/12/2015;JOE & THE JUICE Ai;-40;16579,9;DKK
18/12/2015;Poppi Dyrecenter;-119;16619,9;DKK
18/12/2015;BlackSwan;-55;16738,9;DKK
17/12/2015;laekkerier;-140;16793,9;DKK
16/12/2015;DET FRANSKE CONDIT;-40;16933,9;DKK
16/12/2015;Rema 1000;-22,4;16973,9;DKK
16/12/2015;Rema 1000;-184,9;16996,3;DKK
15/12/2015;Rema 1000;-46,9;17181,2;DKK
15/12/2015;Overførsel fra udland - omkostninger;-20;17228,1;DKK
15/12/2015;Overførsel fra udland;7448,4;17248,1;DKK
14/12/2015;The Coffee Factory;-65;9799,7;DKK
14/12/2015;DSB 650 Kk RKA;-200;9864,7;DKK
14/12/2015;Rema 1000;-151,45;10064,7;DKK
14/12/2015;Dankort Hoopz Frederiksber;-249;10216,15;DKK
14/12/2015;JOE & THE JUICE NY;-184;10465,15;DKK
14/12/2015;Aldi 002;-33,85;10649,15;DKK
11/12/2015;Rema 1000;-53,55;10683;DKK
10/12/2015;Netto Nørrebrogade;-50,45;10736,55;DKK
10/12/2015;Rema 1000;-90,75;10787;DKK
10/12/2015;Gadeforeningen;-65;10877,75;DKK
09/12/2015;Politikens Boghal;-254,15;10942,75;DKK
09/12/2015;Aldi 002;-49,3;11196,9;DKK
08/12/2015;Aldi 002;-88,01;11246,2;DKK
07/12/2015;Rema 1000;-99,75;11334,21;DKK
07/12/2015;Søhesten, Sølvgade;-150;11433,96;DKK
07/12/2015;Rema 1000;-129,94;11583,96;DKK
07/12/2015;AFRICAN TOUCH ApS;-475;11713,9;DKK
07/12/2015;AFRICAN TOUCH ApS;-120;12188,9;DKK
07/12/2015;Cafe Tænk;-230;12308,9;DKK
07/12/2015;Pengeautomat;-300;12538,9;DKK
04/12/2015;Rema 1000;-133,5;12838,9;DKK
04/12/2015;emmerys (140);-134;12972,4;DKK
04/12/2015;Poppi Dyrecenter;-40;13106,4;DKK
04/12/2015;Straksoverførsel gennemført  pr. 03-12-2015/Konto 64970001000373;-8000;13146,4;DKK
03/12/2015;Hillerødgade Bad;-360;21146,4;DKK
03/12/2015;Aldi 002;-66,8;21506,4;DKK
03/12/2015;Dankort-køb Oister;-177,75;21573,2;DKK
02/12/2015;Rema 1000;-122,5;21750,95;DKK
01/12/2015;Aldi 002;-46,35;21873,45;DKK
30/11/2015;BLÅGÅRD DYREKLINIK;-907,34;21919,8;DKK
30/11/2015;Rema 1000;-105,75;22827,14;DKK
30/11/2015;Aldi 002;-133,2;22932,89;DKK
30/11/2015;Rema 1000;-35,34;23066,09;DKK
30/11/2015;Rema 1000;-52,85;23101,43;DKK
27/11/2015;IZ *MELLEMFOLKELIG, KBH;-50;23154,28;DKK
26/11/2015;Rema 1000;-66,2;23204,28;DKK
26/11/2015;SILVAN;-59,95;23270,48;DKK
26/11/2015;Bellahøj Svømmesta;-20;23330,43;DKK
25/11/2015;Rema 1000;-54,95;23350,43;DKK
25/11/2015;Aldi 002;-102,6;23405,38;DKK
25/11/2015;Safir Frugt og Grø;-30;23507,98;DKK
23/11/2015;Rema 1000;-94,45;23537,98;DKK
23/11/2015;Rema 1000;-81,8;23632,43;DKK
23/11/2015;Løven På Christian;-40;23714,23;DKK
23/11/2015;Rema 1000;-54,5;23754,23;DKK
23/11/2015;SILVAN;-208,6;23808,73;DKK
23/11/2015;Rema 1000;-99,95;24017,33;DKK
23/11/2015;DET FRANSKE CONDIT;-50;24117,28;DKK
23/11/2015;Søhesten, Sølvgade;-50;24167,28;DKK
20/11/2015;Dankort Shabaz Sværtegade;-58;24217,28;DKK
19/11/2015;Normann Detail ApS;-104;24275,28;DKK
19/11/2015;Aldi 002;-60,85;24379,28;DKK
18/11/2015;Rema 1000;-91,9;24440,13;DKK
17/11/2015;Mokkariet;-62;24532,03;DKK
16/11/2015;Rema 1000;-52,05;24594,03;DKK
16/11/2015;PALADS TEATRET;-50;24646,08;DKK
16/11/2015;Original Coffee;-67;24696,08;DKK
16/11/2015;DET FRANSKE CONDIT;-101;24763,08;DKK
16/11/2015;Rema 1000;-86,45;24864,08;DKK
16/11/2015;Magasin, Kgs Nytor;-659,55;24950,53;DKK
13/11/2015;Aldi 002;-108,15;25610,08;DKK
13/11/2015;Konto 32640016176850;-100;25718,23;DKK
13/11/2015;Rema 1000;-47,9;25818,23;DKK
12/11/2015;Poppi Dyrecenter;-119;25866,13;DKK
12/11/2015;Rema 1000;-91,1;25985,13;DKK
10/11/2015;Aldi 051;-87,35;26076,23;DKK
10/11/2015;Pengeautomat;-600;26163,58;DKK
09/11/2015;Original Coffee;-67;26763,58;DKK
09/11/2015;Poppi Dyrecenter;-218;26830,58;DKK
09/11/2015;Rema 1000;-30,25;27048,58;DKK
09/11/2015;DET FRANSKE CONDIT;-80;27078,83;DKK
09/11/2015;Rema 1000;-55,86;27158,83;DKK
09/11/2015;DET FRANSKE CONDIT;-54;27214,69;DKK
09/11/2015;Rema 1000;-331,79;27268,69;DKK
09/11/2015;Chilimili;-118;27600,48;DKK
09/11/2015;Noma;-3000;27718,48;DKK
09/11/2015;Dankort Illums Bolighus;-750;30718,48;DKK
06/11/2015;Aldi 006;-75,75;31468,48;DKK
05/11/2015;Poppi Dyrecenter;-377;31544,23;DKK
05/11/2015;P.H. Cykler;-1349;31921,23;DKK
05/11/2015;Rema 1000;-38,85;33270,23;DKK
04/11/2015;Rema 1000;-139,54;33309,08;DKK
04/11/2015;Irma Rosenørns All;-121;33448,62;DKK
04/11/2015;Rema 1000;-123,6;33569,62;DKK
04/11/2015;DET FRANSKE CONDIT;-144;33693,22;DKK
04/11/2015;Dankort-køb Oister;-109,39;33837,22;DKK
03/11/2015;Wood Sound;-200;33946,61;DKK
03/11/2015;AFRICAN TOUCH ApS;-150;34146,61;DKK
03/11/2015;Rema 1000;-37,95;34296,61;DKK
03/11/2015;IZ *DESSERTEN APS, KOBENHAVN K;-90;34334,56;DKK
02/11/2015;SILVAN;-109,9;34424,56;DKK
02/11/2015;Rema 1000;-46,45;34534,46;DKK
02/11/2015;JOE & THE JUICE Jo;-184;34580,91;DKK
02/11/2015;Rema 1000;-54,71;34764,91;DKK
02/11/2015;DET FRANSKE CONDIT;-36;34819,62;DKK
02/11/2015;WARPIGS BREWPUB;-85;34855,62;DKK
02/11/2015;Dankort Social Food Freder;-60;34940,62;DKK
02/11/2015;emmerys (110);-59;35000,62;DKK
02/11/2015;Rema 1000;-15,95;35059,62;DKK
02/11/2015;DSB 650 Kk RKA;-200;35075,57;DKK
02/11/2015;Pengeautomat;-600;35275,57;DKK
02/11/2015;Mikkeller & Friend;-110;35875,57;DKK
30/10/2015;LA TIENDA;-40;35985,57;DKK
30/10/2015;Democratic Coffee;-108;36025,57;DKK
30/10/2015;Rema 1000;-37,5;36133,57;DKK
29/10/2015;Rema 1000;-116,2;36171,07;DKK
28/10/2015;DSB 771 Klu RKA;-200;36287,27;DKK
28/10/2015;coffee 24 v/ Aform;-55;36487,27;DKK
27/10/2015;Rema 1000;-105,75;36542,27;DKK
12/10/2015;Dankort WH-Smith T2 Pier B;-250;36648,02;DKK
09/10/2015;JOE & THE JUICE Ai;-78;36898,02;DKK
09/10/2015;FREDERIKSBERG MATE;-49,95;36976,02;DKK
09/10/2015;Pengeautomat;-400;37025,97;DKK
07/10/2015;Rema 1000;-53;37425,97;DKK
06/10/2015;Visa/Dankort SEK   169,80 Kurs 80,671 Nota nr. 09321 MASTERLIVS, MALMO;-136,98;37478,97;DKK
06/10/2015;Visa/Dankort SEK   105,00 Kurs 80,676 Nota nr. 46776 SKANETRAFIKEN, MALMO C;-84,71;37615,95;DKK
05/10/2015;Rema 1000;-46,15;37700,66;DKK
05/10/2015;Rema 1000;-35;37746,81;DKK
05/10/2015;Rema 1000;-96,3;37781,81;DKK
05/10/2015;SØPAVILLONEN;-40;37878,11;DKK
05/10/2015;SØPAVILLONEN;-40;37918,11;DKK
02/10/2015;DSB København;-89;37958,11;DKK
01/10/2015;Rema 1000;-55,9;38047,11;DKK
30/09/2015;Aldi 002;-103,25;38103,01;DKK
29/09/2015;The Coffee Factory;-72;38206,26;DKK
29/09/2015;CITS V SERVICE (DE;-1525;38278,26;DKK
29/09/2015;Blomsterskuret V/L;-325;39803,26;DKK
29/09/2015;Foodie I/S;-105;40128,26;DKK
29/09/2015;IZ *ISTID I S, KOBENHAVN N;-45;40233,26;DKK
28/09/2015;Rema 1000;-132,6;40278,26;DKK
28/09/2015;Jasmin Corner;-345;40410,86;DKK
28/09/2015;HOOHA;-379;40755,86;DKK
28/09/2015;MALING.DK;-49,95;41134,86;DKK
24/09/2015;Aldi 002;-42,9;41184,81;DKK
24/09/2015;Rema 1000;-88,64;41227,71;DKK
23/09/2015;Rema 1000;-71,4;41316,35;DKK
23/09/2015;AGODA.COM, LONDON;-2161,73;41387,75;DKK
22/09/2015;AGODA.COM, LONDON;-11,17;43549,48;DKK
21/09/2015;Rema 1000;-43,45;43560,65;DKK
21/09/2015;Epidemiklinikken;-570;43604,1;DKK
21/09/2015;Rema 1000;-80,9;44174,1;DKK
21/09/2015;Selmas Is Aps;-66;44255;DKK
21/09/2015;DET FRANSKE CONDIT;-30;44321;DKK
18/09/2015;Coffee First;-73;44351;DKK
18/09/2015;Rema 1000;-93,75;44424;DKK
17/09/2015;RADIOKIOSKEN;-50;44517,75;DKK
16/09/2015;Rema 1000;-161,15;44567,75;DKK
16/09/2015;DET FRANSKE CONDIT;-50;44728,9;DKK
15/09/2015;Palæo;-126;44778,9;DKK
15/09/2015;Rema 1000;-135,8;44904,9;DKK
14/09/2015;SILVAN;-69,95;45040,7;DKK
14/09/2015;Brød Værten;-58;45110,65;DKK
14/09/2015;SILVAN;-209,7;45168,65;DKK
14/09/2015;DET FRANSKE CONDIT;-48;45378,35;DKK
14/09/2015;Rema 1000;-143,45;45426,35;DKK
14/09/2015;LA TIENDA;-80;45569,8;DKK
14/09/2015;Democratic Coffee;-55;45649,8;DKK
14/09/2015;Aldi 002;-142,7;45704,8;DKK
11/09/2015;MATAS - 14420;-41,95;45847,5;DKK
10/09/2015;Rema 1000;-58,95;45889,45;DKK
10/09/2015;IZ *ISTID I S, KOBENHAVN N;-160;45948,4;DKK
09/09/2015;Rema 1000;-58,9;46108,4;DKK
07/09/2015;Mormors;-135;46167,3;DKK
07/09/2015;Rema 1000;-62,8;46302,3;DKK
07/09/2015;Rema 1000;-92,61;46365,1;DKK
07/09/2015;DET FRANSKE CONDIT;-48;46457,71;DKK
07/09/2015;DAGMAR TEATRET A/S;-190;46505,71;DKK
07/09/2015;F.S. PLUS SERVICE;-50;46695,71;DKK
04/09/2015;Rema 1000;-97,95;46745,71;DKK
02/09/2015;Rema 1000;-50,1;46843,66;DKK
01/09/2015;Rema 1000;-142;46893,76;DKK
01/09/2015;Dankort-køb SILVAN 314 eShop;-2798,95;47035,76;DKK
31/08/2015;Københavns Universit;11468,07;49834,71;DKK
26/08/2015;Rema 1000;-60,35;38366,64;DKK
24/08/2015;Rema 1000;-74,9;38426,99;DKK
24/08/2015;DSB 650 Kk RKA;-200;38501,89;DKK
24/08/2015;Rema 1000;-33,25;38701,89;DKK
24/08/2015;Democratic Coffee;-108;38735,14;DKK
24/08/2015;Rådhusoplysningen,;-95;38843,14;DKK
24/08/2015;Rema 1000;-102,25;38938,14;DKK
20/08/2015;Aldi 002;-104,25;39040,39;DKK
20/08/2015;Rema 1000;-112,15;39144,64;DKK
19/08/2015;Dankort 7-Eleven B 021;-25;39256,79;DKK
17/08/2015;Foodie I/S;-130;39281,79;DKK
17/08/2015;JOE & THE JUICE Fr;-152;39411,79;DKK
17/08/2015;Rema 1000;-101,95;39563,79;DKK
14/08/2015;Rema 1000;-40,7;39665,74;DKK
12/08/2015;Inspiration;-59,9;39706,44;DKK
12/08/2015;Rema 1000;-166,55;39766,34;DKK
11/08/2015;Pengeautomat;-500;39932,89;DKK
10/08/2015;Rema 1000;-145,35;40432,89;DKK
10/08/2015;Coffee First;-145;40578,24;DKK
10/08/2015;Isenkræmmer Hartma;-45;40723,24;DKK
07/08/2015;Aldi 008;-117,45;40768,24;DKK
05/08/2015;Rema 1000;-157,15;40885,69;DKK
03/08/2015;Risteriet Tisvilde;-60;41042,84;DKK
03/08/2015;Rema 1000;-85,25;41102,84;DKK
03/08/2015;Bacchouse;-73;41188,09;DKK
03/08/2015;Trævarefabrikkerne;-1901;41261,09;DKK
03/08/2015;Aldi 006;-81,3;43162,09;DKK
31/07/2015;Brød Værten;-224;43243,39;DKK
31/07/2015;Døgnnetto Jagtvej;-70,5;43467,39;DKK
31/07/2015;Københavns Universit;11468,07;43537,89;DKK
31/07/2015;Rema 1000;-245,8;32069,82;DKK
29/07/2015;Aldi 002;-92,3;32315,62;DKK
28/07/2015;Original Coffee;-67;32407,92;DKK
27/07/2015;Lidl;-145,75;32474,92;DKK
27/07/2015;Rema 1000;-94,25;32620,67;DKK
27/07/2015;FRELLSEN CHOKOLADE;-55;32714,92;DKK
27/07/2015;Netto-Bådene;-240;32769,92;DKK
27/07/2015;Dankort Madklubben Vesterb;-700;33009,92;DKK
27/07/2015;M Forum RVM;-200;33709,92;DKK
27/07/2015;WARPIGS BREWPUB;-195;33909,92;DKK
27/07/2015;Sømods Bolcher, Fr;-104;34104,92;DKK
27/07/2015;Pengeautomat;-500;34208,92;DKK
23/07/2015;IceQueen;-70;34708,92;DKK
21/07/2015;KAFFESALONEN ApS;-61;34778,92;DKK
20/07/2015;Rema 1000;-103,75;34839,92;DKK
20/07/2015;Rema 1000;-119,55;34943,67;DKK
20/07/2015;Pizzicato;-48;35063,22;DKK
17/07/2015;SECRET HAIR CARE;-150;35111,22;DKK
17/07/2015;Deres Købmand v/Mu;-100;35261,22;DKK
17/07/2015;Rema 1000;-98,15;35361,22;DKK
14/07/2015;NS ZANDVOORT AAN ZEE, ZANDVOORT AAN EUR 16,90;-127,4;35459,37;DKK
14/07/2015;NS SCHIPHOL, LUCHTHAVEN SC EUR 8,70;-65,59;35586,77;DKK
14/07/2015;AH TO GO 5868, AMSTERDAM CS EUR 6,00;-45,23;35652,36;DKK
13/07/2015;Rema 1000;-84,5;35697,59;DKK
10/07/2015;Rema 1000;-20,5;35782,09;DKK
09/07/2015;Rema 1000;-80,8;35802,59;DKK
07/07/2015;Baresso Coffee A/S;-113;35883,39;DKK
06/07/2015;Rema 1000;-108,35;35996,39;DKK
06/07/2015;Rema 1000;-52,9;36104,74;DKK
06/07/2015;Rema 1000;-150,3;36157,64;DKK
06/07/2015;Aldi 002;-105,71;36307,94;DKK
06/07/2015;Pengeautomat;-400;36413,65;DKK
03/07/2015;Rema 1000;-41,45;36813,65;DKK
30/06/2015;Københavns Universit;11468,07;36855,1;DKK
30/06/2015;Rema 1000;-85,4;25387,03;DKK
29/06/2015;Rema 1000;-88,4;25472,43;DKK
26/06/2015;Trævarefabrikkerne;-2024;25560,83;DKK
25/06/2015;Aldi 002;-43,95;27584,83;DKK
25/06/2015;IZ *TACOPOP IVS, OSTEBRO;-100;27628,78;DKK
24/06/2015;Rema 1000;-135,05;27728,78;DKK
23/06/2015;Rema 1000;-98,85;27863,83;DKK
22/06/2015;Politikens Boghal;-149,95;27962,68;DKK
22/06/2015;Tante T Torvehalle;-75,4;28112,63;DKK
19/06/2015;Aldi 002;-187,05;28188,03;DKK
19/06/2015;Bellahøj Svømmesta;-360;28375,08;DKK
17/06/2015;Rema 1000;-79,4;28735,08;DKK
16/06/2015;Rema 1000;-136,65;28814,48;DKK
16/06/2015;IZ *RED CHINA, KOBENHAVN K;-150;28951,13;DKK
15/06/2015;Olufs IS;-64;29101,13;DKK
15/06/2015;Dankort Cafe Væksthuset;-115;29165,13;DKK
15/06/2015;M Chr.havn RVM;-200;29280,13;DKK
15/06/2015;Hav Torvehallerne;-100;29480,13;DKK
15/06/2015;ISoBar;-66;29580,13;DKK
15/06/2015;MATAS - 14427;-52,25;29646,13;DKK
15/06/2015;Juicy;-156;29698,38;DKK
15/06/2015;Rema 1000;-118,2;29854,38;DKK
11/06/2015;Aldi 051;-45,8;29972,58;DKK
09/06/2015;Rema 1000;-127,25;30018,38;DKK
08/06/2015;Irma Fr.Borggade;-68;30145,63;DKK
08/06/2015;Bootleggers;-45;30213,63;DKK
08/06/2015;Bootleggers;-45;30258,63;DKK
08/06/2015;Bootleggers;-45;30303,63;DKK
08/06/2015;Cleaver's Meat Mar;-60;30348,63;DKK
08/06/2015;Lauras Bakery;-125;30408,63;DKK
08/06/2015;Inspiration;-79,95;30533,63;DKK
08/06/2015;Rema 1000;-174,5;30613,58;DKK
08/06/2015;Rema 1000;-127,95;30788,08;DKK
02/06/2015;Aldi 002;-83,25;30916,03;DKK
02/06/2015;Rema 1000;-49;30999,28;DKK
01/06/2015;Dankort riccos butik og ka;-150;31048,28;DKK
01/06/2015;Rema 1000;-124,2;31198,28;DKK
01/06/2015;A. BUSCK, KBH;-129,95;31322,48;DKK
01/06/2015;ATM 403862 0400-3038;-500;31452,43;DKK
29/05/2015;Københavns Universit;11468,07;31952,43;DKK
28/05/2015;Grillen Nørrebroga;-134;20484,36;DKK
27/05/2015;Visa/Dankort SEK   193,00 Kurs 81,559 Nota nr. 92001 SLOTTSTRADSGAARDS CAFE, MALMO;-157,41;20618,36;DKK
27/05/2015;Visa/Dankort SEK   189,00 Kurs 81,560 Nota nr. 73800 SKANETRAFIKEN, MALMO C;-154,15;20775,77;DKK
27/05/2015;Visa/Dankort SEK    89,90 Kurs 81,568 Nota nr. 64854 MASTERLIVS, MALMO;-73,33;20929,92;DKK
27/05/2015;Rema 1000;-123,55;21003,25;DKK
26/05/2015;Dankort Rist v/Anne-Line N;-56;21126,8;DKK
26/05/2015;Rema 1000;-170,3;21182,8;DKK
26/05/2015;Aldi 002;-157,7;21353,1;DKK
26/05/2015;Blomsterskuret;-60;21510,8;DKK
22/05/2015;Rema 1000;-124,15;21570,8;DKK
21/05/2015;Rema 1000;-84,25;21694,95;DKK
20/05/2015;Paradis Trianglen;-65;21779,2;DKK
19/05/2015;Aldi 002;-161,25;21844,2;DKK
18/05/2015;M Nørreport RVM;-280;22005,45;DKK
18/05/2015;F.S. PLUS SERVICE;-120;22285,45;DKK
18/05/2015;Rema 1000;-83,91;22405,45;DKK
18/05/2015;Games/Karrusella;-129;22489,36;DKK
18/05/2015;Nutid;-86;22618,36;DKK
18/05/2015;EVENT CREW ApS;-90;22704,36;DKK
18/05/2015;EVENT CREW ApS;-90;22794,36;DKK
12/05/2015;Ifølge separat advis nr.;22884,36;22884,36;DKK